Igicuma bashyiramo amata : Icyansi

Ibyo bakoresha mu mata byose : Ibyansi

Aho batereka amata : Uruhimbi

Kuyasuka mu gisabo : Kuyabuganiza

Kuyavanamo amavuta : Gusobanura

Kubika icyansi, igisabo : Kukiranga

Kurangiza koza icyansi : Guhumuza

Kurangiza gukama : Guhumuza

Kumena amata ubishatse : Kuyabyarira

Kumena amata utabishatse : Kuyabogora

Kumena Igisabo : Kukibyarira

Kumara amata mu kintu : Kuyagwizamo

Kurekeraho gukamwa : Guteka

Uduta : Amata

Amata y'inka ikibyara : Umuhondo

Amata y'inka yenda guteka : Amagonera, Amanga, Amasunga

Amata y'inka Ihaka : Amasitu

Amata inyana yanze konka : Amakaba

Ayaraye ataravura : Umubanji

Amata bavanze n'amazi : Umwerera

Amata yiriwe : Amirire

Amaze kuvura : Ikivuguto

Amata y'abashumba : Imyezo

Agati bavurugisha amata : Umutozo

Gutunganya amata y'ikivuguto : Kuyavuruga

Umuheha banywesha amata : Umuceri

Ibyo banywesha amata : Imikerenke, injome, imimuna

Amazi asohoka mu moko mbere y'uko inka ibyara : Inkanya 

Amata bagikama : Inshyushyu

Kuyasuka mu gisabo : Kuyabuganiza

Kuyavanamo amavuta : Kwavura, gusobanura

Kubika icyansi, igisabo : Kukiranga

Kurangiza koza icyansi : Guhumuza 

Kumena amata ubishaka : Kuyabikira, kuyabyarira

Kuyamena agucitse : Kuyabogora

Uduta : Amata 

Amata y'inka ikibyara : Umuhondo 

Amata y'inka yenda guteka : Amagonera, amasuga, amanga

Amata y'inyana yanze konka : Amakaba 

Amata y'inka yimye : Amasitu 

Ayaraye ataravura : Umubanji

Ayiriwe ataravura : Amirire

Amaze kuvura : Ikivuguto

Ay'abashumba : Imyezo

Ay'ikivuguto kitavuruze : Amenda

Agati bavurugisha : Umutozo 

Umuheha banywesha amata : Umuceri 

Ay'inka yapfushije : Ubusuri

Amata ava mu koza igisabo cg mu mavuta : Umujago

Amata avanze n'amazi : Umwerera

Ayo ikamwe bwa kabiri : Amarindira

Amavuta akiva mu gisabo : Amaresanyo 

Amaze amezi nk'abiri : Amavuta y'igisore

Amaze amezi atandatu : Amavuta akuze

Ayacamukijwe agashyirwamo imibavu : Amadahano 

Amavuta yisigwa : Ikimuri 

Aho umwami yabonaniraga n'abaturage : Ku karubanda

Aho umwami yaciraga imanza : Ku gitabo cy'intarengwa

Irembo ryo mu gikari : Icyanzu

Imbere mu nzu : Mu mbere

Aho abantu baganirira mu rugo : Mu mbuga

Aho basohokera bataha : Ku irembo

Ibiti 2 banyuramo hagati bajya ku irembo : Ibikingi by'amarembo

Ibiti bakingisha mu irembo : Imyugariro

Igitandukanya icyumba n'ikindi mu nzu ya kinyarwanda : Inyegamo

Igiti bakwikiramo isuka : Umuhini

Imbere h'umuheto : Ku ruhembe

Isonga ry'uruhindu (umunwa) : Umuretso

Aho babika inkota : Urwubati

Ibiti bitandukanya isambu n'indi : Urubibi

Ndavuze ati : Ndavuze nti 

Nari nataramubona : Nari ntaramubona

Mubigenze utyo : Mubigenze mutyo 

Wari wakubitwaho? : Wari wakubitwa? 

Rutahizamu w'iyo kipe yavuye mu mvune : Rutahizamu w'iyo kipe yakize imvune

Yiga Amerika : Yiga muri Amerika

Ntiza ku ikaramu nandike : Ntiza ikaramu nandike

Kugendera kimwe : Kugendera rimwe

Siyaje : Ntiyaje

Imana ibahereze umugisha : Imana ibahe umugisha

Aduhe ubusobanuro burambuye : Aduhe ibisobanura birambuye 

Sugende : Ntugende

Amago : Ingo

Amakwe : Ubukwe

Amanama : Inama

Ariho amazi abira : Ari mu mazi abira

Naryamye natariye : Naryamye ntariye

Abajama : Urungano

Amaniga : Bagenzi bange

Ndamuyoka : Ndamubona (Ndamutahura) 

Uno mukobwa arahiye : Uno mukobwa ni mwiza

Iyo ufite komitimenti [commitment] kubaka inzu ntibigora : Iyo wabyiyemeje kubaka Inzu  ntibigora

Sisiteme [system] dukoreramo : Uburyo dukoreramo

Ikintu cyo mbaza : Ikintu mbaza

Uwo muntu yafashwe ari kumwe n'ibiyobyabwenge : Uwo muntu yafatanywe ibiyobyabwenge

Mushiki wa data : Masenge 

Musaza wa mama : Marume 

Se wa data, mama : Sogokuru 

Nyina wa data,  mama : Nyogokuru 

Se wa sogokuru, nyogokuru : Sogokuruza 

Nyina w'umugabo, umugore wange : Mabukwe 

Murumuna, mukuru wa data : Data wacu 

Umwana wa musaza w'umuntu : Umwisengeneza 

Umwana wa mushiki w'umuntu : Umwishywa 

Umwana w'umwuzukuru : Umwuzukuruza 

Umwana w'umwuzukuruza : Ubuvivi 

Umwana w'ubuvivi : Ubuvivure 

Umwana wa nyirarume, nyirasenge w'umuntu : Umubyara, mubyara waâ€¦ 

Se (nyina) b'umukwe wawe, umukazana wawe : Bamwana wawe 

Murumuna, mukuru, musaza w'umugore wange : Muramu wange 

Umugabo wa mushiki wange : Muramu wange 

Mushiki w'umugabo wawe : Muramukazi 

Abashatse abagore bava inda imwe : Abasanzire 

Inka nyinshi : Ishyo (Zigeze ku munani)

Ishyo ryinshi : Amashyo (umwikubo w'ishyo rirenze rimwe)

Intama,ihene nyinshi : Umukumbi (Zigeze ku munani)

Umukumbi mwinshi  : Imikumbi (umwikubo w'umukumbi urenze umwe)

Ingurube nyinshi : Umugana (zirenze imwe)

Umugana mwinshi : Imigana (Umwikubo w'umugana urenze umwe)

Imbwa nyinshi : Umukeno (zirenze imwe)

Umukeno mwinshi : Imikeno (Umwikubo w'umukeno urenze umwe)

Amashyi menshi : Urufaya

Indirimbo nyinshi : Urwunge

Amajwi menshi : Urwunge

Impundu nyinshi : Urwanaga

Gutangira gusya : Kwanzika 

Kurangiza gusya : Kwanzura 

Ibuye baseraho : Urusyo 

Ibuye bashesha : Ingasire 

Kudonda urusyo : Gukoma urusyo

Ibuye bakomesha urusyo : Intosho 

Gutega urusyo ngo rudatemba : Kurushyigikira 

Amasaka make arunze ku rusyo : Itsinda 

Umushishi, Agashinge bahanaguza urusyo : Umwanzuzo 

Kugura urusyo : Gukosha urusyo 

Kumeneka k'urusyo : Gusandara 

Gusaza k'urusyo : Gukura 

Ifu inoze cyane : Inono 

Kwigizayo ifu basya : Gukoma ifu

