Umutagara : Ingoma zigize umukino, umuriri w'ingoma

Gusiga ingoma : Kuzitera amaraso y'inka ngo zitamungwa

Gukosha ingoma : Kuzigura

Kuramvura ingoma : Kuzibaza

Kurema ingoma : Kuzibambaho uruhu

Kuremera ingoma : Kuzikorera

Kururutsa ingoma : Kuzitura

Kuza kw' ingoma : Gutaha

Kuzijisha : Kuzibika (iyo hari ahantu hegutse zagenewe)

Kuzibyarira : Kuzitaba mu gitaka

Kuzibikira : Kuzibika

Gukura : Gusaza kwazo

Kurara : Gusaduka iyo zikiri nshya

Kuribora : Gusaduka iyo zishaje

Kubyara : Gutoboka

Kuzosa : Kuzishyira ku gicaniro

Kurenga : Kuvuga zikaraza iyo zashyushye cyane

Gusuka : Gutangira kuvuga

Gutuza : Guceceka

Gutunga : Kurangiza kuvuga

Gutungisha : Kuvuza umurishyo wo kurangiza

Umurishyo utungisha : Utuma barangiza kuvuza

Umurishyo ubikira : Wa nimugoroba, usinziriza

Umurishyo Ubambura : Wa mu gitondo, ukangura

Indamutsa : Ingoma itanga bwakeye

Kuvuga urwunge : Kuvugira icyarimwe kw'ingoma

Kubyukira : Kuvuga bugicya

Kuvunura : Guhindukira kw'ingoma

Gusegura : Gushyigikira ingoma

Gutambira ingoma : Kuzishayayira, kuzibyinira umamata

Kurambagira : Gutambagira by'ingoma

Gukuka : Kuva mu ibarizo

Gukura : Kuvana ingoma mu ibarizo

Imyari : Ingoma zitarambara

Kuzambika : Kuzishyiraho uruhu

Kwambara : Kujyaho uruhu

Kwogosha (ingoma) : Kuyivuza ikiremwa ngo iveho ubwoya

Ingabe : Ingoma igenga igihugu

Ibigamba : Ingoma z'ibyegera by'ingabe

Kuzirika ukwezi : Gufata igihe kw'Abiru bavuza ingoma

Umuziritsi : Umutware w'Abiru bavuza ingoma bari ku gihe

Kuzirika ingoma : Kureka kuzivuza mu gisibo cya Gicurasi

Ingoma ziraziritse : Ingoma ntizishobora kuvuga

Kuzirikisha : Kuba umugenga w'Abiru bavuza ingoma bafashe igihe

Gusibira umurishyo : Kongera kuwuvuza

Amaboko y'ingoma : Imikondo yazo bafata iyo baziterura

Urukamishirizo : Aho ingoma zivugira, aho zibikwa

Ikiraro cy'ingoma : Aho zi ba

Impuruza, intabaza : Umurishyo ushoreza urugamba

Umutimbo, agatimbo : Umurishyo ubambura ukanabikira

Gukura gicurasi : Kwerera ukwezi gushya kwa Kamena

Kubundisha ingoma : Kuyihisha mu gihe cy'intambara bashaka kuyinyaga

Kunoshereza : Kuvuza umamata, gahoro
