Gusubiza inyuma : Gukumira

Kurangiza gukama : Guhumuza

Kurangiza gushitura : Guhaza

Kurorera gukama : Guteka

Gukamana ingoga : Gukama kera

Gukomereka  : Gusarika

Kuzijyana kuziragira : Kuzahura

Gutoroka kw'inka : Kumena

Kurya kw'inka : Kurisha

Aho inka zirishiriza : Urwuri

Kwahura kure : Guturuka kure

Kuzigarura mu rugo : Kuzicyura

Guca umurizo : Gukemura umurizo

Gukurura babyaza : Kuvutira

Kuramburura kwazo : Kumurika

Kuzirasa amatezano : Kuzikama

Gukamisha yombi : Kuvuruganya

Gushyiraho inka iyayo : Kwinikiza

Gutwita kw'inka : Guhaka

Kujya ku nda kwazo : Kwerera

Kuziyobora, kuzishorera : Kuzirongora

Kuzijyana ku kibumbiro : Gushora

Kujyana inka ahari ubwatsi : Kugisha

Guca ubwatsi bw'inka : Kwahira

Inkoni baragiza inka : Inshyimbo

Ibyatsi bahanaguza inka : Inkuyo

Kwiruka zigusiga : Gutara

Guhanagura inka : Kuzihonora

Guta umuziha kwazo : Gufuma

Kwenda kwima zitararinda : Kuba mu bitwarizi

Kuzivomera : Kuzidahirira

Kuzishyira imfizi : Kuvuna umurizo (kubangurira)

Kubura amazi kwazo : Kurumanga

Guca inka ibere : Kuryogosha

Kurwara ibisebe ku mabere : Gusarika

Ibihamagazo byazo : Amazina yazo

Inzu y'inyana : Uruhongore

Inzu y'inka : Ikiraro

Aho inka zibyagira : Mu ngombe

Ibiti bikinga inzu y'inka : Ibihindizo

Gukura amase mu kiraro : Gukuka

Aho bamena amase y'inka : Icukiro

Kubora kw'amase : Gushanguka

Inka y'umuriro : Inka itangirirwaho korora (uva mu boro ukaba umworozi)

Ibyatsi basasira inka : Icyarire

Utubere tudakamwa : Indorerezi

Umunani ukinze : Inka umunani n'inyana zazo

Umunani wumanye : Inka umunani zitarabyara, cyangwa zidafite izazo

Gushira inyuma	: Guhumuza inyuma

Gusuhuka : Kugisha 

Gukamwa make : Gukamwa menshi

Kubuza inyana konka : Kuyiramura 

Guca umurizo : Kogosha  

Itagira amahembe : Inkungu 

Gukurura babyaza : Gukemura umurizo

Kurekura inyana no yonke : Kwinikiza 

Umushumba zasize : Yasomeyehe, zarengeyehe

Kwiruka zigusiga : Gutana

Kwenda kwima zitararinda : Kuba mu bitwarize

Kuzivomera : Kuzidahira

Kuzishyira imfizi : Kuzibangurira, kuvuna umurizo

Kurwara ibisebe ku mabere : Kurwara ibisare

Ibihamagaro byazo : Amazina yazo

Uzitegeka : Umutahira 

Guhatira inka ngo yonse iyayo : Gutsindira 

Kunanirwa kubyara kw'inka : Gukika

Uzirabira : Umushumba, umufatankoni

Umushumba utazi undi mwuga : Rwoga 

Ukuka amase : Umurenzamase

Isaso yazo : Icyarire 

Amaboko y'inka mu ibyara : Inkoni 

Inzu y'inyana : Uruhongore 

Utubere tw'inyongera tudakamwa : Indorerezi 

Idafite impakamano : Inyamuno 

Agahu irigata yapfushije : Akaraga

Aho zinywera ku mugezi : Umwaro 

Umugezi zafukuriwe : Ikibumbiro 

Ibizihanagura : Inkuyo

Inyana ntizisubira ku gasozi : Zisubizwa iswa

Inka ipfushije iyayo : Isuri 

Aho umuriro wazo uri : Igicaniro 

Kwatsa igicaniro : Gukangura igicaniro

Igicaniro ntikizima : Kirasinzira 

Gupfa kw'imfizi : Gusinzira 

Inka umukobwa ahabwa n'umubyeyi we ku mwana we wese : Inka y'icyari

Kunka itari nyina : Kugoba

Kurangiza kunywa kwazo : Gukuka 

Gusigwa amase ku mabere banga ko zonka : Guhoreza

Kwishyura wemeza ko uwakugwatirije akukana ingwate : Gukoma ihembe

Inyana yishyurwa uwagwatirije : Umukangara 

Igumbaha ikagumbahuka : Ingumba 

Igumbaha igaheranwa : Inshura 

Iziba kwa nyirazo : Intarama, intahira

Izijyana na nyirazo ku macumbi : Ingishywa, inyarurembo

Inyana yatinze kwima : Urubereri

Inyana itima rwose : Isave 

Kugabana inka ya mbere : Gucyura ubuhake

Kugabana ubwa kabiri : Guhetwa impetano

Izikamirwa shobuja zizagaruka : Inkuke 

Umushumba w'inka ntarya : Aranywa

Inyana ikivuka : Umutavu 

Uduse tw'umutavu : Udususwe 

Kwica akamasa k'inka bashaka gutsindira inyana : Kugakubita

Inka umuntu yihahiye : Imbata 

Inka y'ubutwari : Inka y'umuheto

Inka itarapfusha : Inka y'isugi 

Inka ucibwa kubera wahunze urugamba : Inka y'imirindi

Inka umubyeyi asigaranye amaze kuraga abana be : Ingarigari 

Inka ikomoka ku yo wakoye : Indongoranyo 

Inka umukobwa ahabwa n'iwabo yajyanye urugori rwa mbere : Inka y'urugori

Umuriro wazo wirukana isazi : Igicaniro 
	