Umwami : Umugabe

Nyina w'umwami : Umugabekazi

Umugore w'umwami : Umwamikazi

Abana b'umwami : Ibikomangoma

Umurambo w'umwami : Umugogo

Kumubyutsa : Kumubambura

Kumusinziriza : Kumubikira

Kugenda : Kurambagira

Kurya : Gufungura

Kurangiza kurya : Kwijuta

Gupfa : Gutanga

Uburiri bw'umwami : Igisasiro

Inzu y'umwami : Ingoro

Kujya ku ngoma : Kwima ingoma

Kubyuka : Kwibambura

Kuryama : Kwibikira

Kurwara : Kuberama

Kwicara : Guteka

Intebe ye : Inteko

Ingobyi ye : Ikitabashwa

Aho aramirizwa : Ijabiro

Kumuha ikuzo : Kumuramya

Kujya ku musarane : Gutwikira ibirenge

Kujya kwaka akazi : Gushaka ubuhake

Kumusinziriza : Kumubikira 

Gutembera : Kurambagira 

Kurya : Kurora

Inzu : Ingoro 

Gusinzira : Kwibikira 

Kurwara : Kuberana

Intebe y'umwami : Inteko 

Umwami w'umugore : Umwamikazi 

Gushyingura umurambo w'umwami : Gutabariza umugogo w'umwami

Imva y'umwami : Umusezero 
