Abakobwa banjye babyina bose : Imirya y'inanga

Abana banjye barara bahagaze bakirirwa bahagaze : Inkingi

Abagwabiro bashinze inteko : Umucaca

Abakobwa ba Ruhinda baturutse ikuzimu bambaye inyonga : Insina; amateke

Abakobwa banjye baranaga amajosi : Urugoyi rw'ibishyimbo

Abakobwa banjye baraturanye ariko ntibaramukanya : Inkombe z'uruzi

Abakobwa banjye bose bikwije impindu : Imirizo y'imbeba

Abambarantama ba Ntaragonda batwara amacumu bayacuritse : Imirizo y'inka

Abambari ba Ruhinda bambariye inzogera ikuzimu : Imigozi y'ibijumba; inkwana z'amateke

Abana b'abarundi barasana bakiri bato : Ifurwe

Abana ba mukeba bambaye imigoma bose : Ibigori

Abana banjye bangana bose : Ifundi

Abana banjye bavuyemo umwe ntiwabimenya : Akatsi ko ku nzu

Abana banjye bicaye bose : Ibirundiro

Abana banjye ndabasasira ntibaryame : Ikawa

Abarebare baje ubu : Imihanda, uruzi, inzira

Abasore b'i Gisaka barasana bakiri bato : Isusa

Abazungu bazanye byinshi n'ibizatuzura : Ifaranga

Abazungu b'i Bujumbura baca urubanza bicaye : Imigomdoro yibishyimbo

Agakecuru ka;anutse i Nyarushurushuru kiteye imirwa munani : Intete z'ibigori

Aho Mutara na Mutaga barasaniraga n'ubu haracyatorwa inkurwe : Uruhara rw'umusaza

Aho Mutara na Mutaga barwaniye ntiharamera utwatsi : Agatsinsino

Aho Mutara na Mutaga barasaniraga hacitse ubikuba : Urwogerezo

Aho wabereye wari waterera Muhangiro : Ikirunga

Aho wakabona kagutera guseka : Ikigori

Aka kayira kasiba twashira : Akayira kajya mu kigega

Akababaje umugabo kamurenza impinga : Ifaranga

Akabindi ka Mbindigiti gatetse amara y'inkuba : Umwobo w'impiri

Aka kagabo kahina so : Icyanzu, ubunyereri

Aka kariza so : Akanyarirajisho

Aka katega so : agacaca

Aka Manimbanimba aka Macikakingoma zo kwa Makombe : Inyundo mu ruganda

Akamarimari kamanutse i Burayi kaje kamara abantu : Ifaranga

Amasaka y'i Burundi atukura ateze : Amaguru y'inkware

Akana kanjye ni maguru ya Sarwaya : Ibaruwa

Akamatana k'amatanage kiyereka mu mpinga ya Bwanakweri : Akanyugunyugu

Akavumu k'iwacu ni imbungiramuhigo : Agakono k'amanywa

Akayuriyuri kwa Ntibazirikana inshuti y'urupfu : Ibitotsi

Amabuye ya Nyirubuyenge wayabara ntiwayashobora : Ukwezi n'inyenyeri

Amaherere yamennye Bukungu umutwe : Igihepfu ku mugina

Ayii : Umukecuru wataye ikijigo cye

Ayiiii, icyamha nkagera iwacu : Umukecuru wurira ikigega

Ayi mama hiya : Inuma ku rukoma

Bacuye dutanguranwe : Ifaranga

Bagatake bagasamaze bakabihise ubwiza bwako : Imanzi mu maribori

Bagiteye icumu gicumba umwotsi : Ikinyugunyugu

Baguhaga akabando urwaye iki? : Igikoro

Bakobwa ntimukanseke nabuze aho mpisha : Innyo y'ihene

Banterere anyuze aha : Umugore utwite

Baragata bakagatanaga ubwiza bwako : Igitiritiri

Barugerageze imigozi barushyire hagati y'abagabo : Umutsima

Basenye ibikingi by'amarembo Rutamu yanze gukwirwamo : Nyiramaningiri

Bateze ibisage bose : Imisatsi y'ibigori

Bicinyira bya bikangaga bikonda byacuzwe n'abantu : Ibirago

Bihindira ikuzimu : Inkono y'amapfa

Bikumburanye bibana : Amabere

Birafora ntibirase : Ingoto y'umugabo

Biratinyana : Umwijima n'urumuri

Bisa bidasa : Ikawa n'umumenamabuye

Ca bugufi uce nyokobukwe indiba y'innyo : igikoro, igihaza

Cya matambatamba cya maguru munani : Uruyuzi

Cyamatimbatimba cyamaguru umunani umwana w'umushoferi akandagiye iburayi : Igitagangurirwa

Fata agafuni nanjye mfate akandi tujye gushaka icyabuze : Umuzi w'urutare

Fata akebo nanjye mfate akandi tujye kwahira intagwira : Ubwoya bw'inka

Fata rutendera ntagwe mu mazi : Amabya

Fata so nkunkumure nyoko : Urwiri

Gakore bakwice : Umuvugirizo wa ninjoro

Hakurya mu gihuku : Inzu itagira abantu

Hano ngo shi na hano ngo shi : Igisheke

Hepfo aha hanyuze akabindi gasenze amatito : Umugore utwite

Hepfo ngo pi, hirya ngo pi : Imvura

Ibuye ry'umusozi ryimuye umugabo : Ifaranga

Icwende ryanjye rimbaye kure mba ngukoreyemo : Ukwezi

Imbehe za Nyirabangana zingana zose : Isi n'ijuru

Inka yanjye nyikama igaramye : Umuvure

Ino karahari n'i Kongo karahari : Ifaranga

Inyabutatu yagiye kwenda inyabutanu kwa mirongo itanu : Igitagangurirwa

Inyama y'urusaku mu rugo rw'imiseke imbere nyamagana : Ururimi n'amenyo

Kaba gato kaba kanini kataye umugabo inyuma y'inzira : Ifaranga

Kamanutse ijuru kaza gukora ishyano mu Rwanda : Ifaranga

Karadundaraye : Akabyindi k'umushumba

Karakurizaga karakurutaga wa duri we? : Akanyarirajisho

Karihuta : Igare

Karuhura mukuru w'urupfu : Ibitotsi

Kati hii kati huu : Agakecuru kocyejwe n'igikoma

Kati papari kati pa! : Akarere ku nsina

Kirabyataraye ku ntebe y'ikinyarwanda : Ikibya cy'umusaza

Ko undeba ndaguha : Imyenge y'inzu

Kuba ahirengeye siko kwumva : Agasongero k'inzu

Kubita ibitoki bya so byo kunsaba inyama : Ibibabi by'ikibonobono

Mama arusha nyoko amabuno manini : Igisabo

Mama nanjye nararushye : Akarago ko mu irebe

Mama nshuti : Ikirago

Mfite igihugu cy'abagabo : Imisatsi y'ibigori

Mfite umugabo unganza : Ibitotsi

Mfite umukobwa wanjye uje wese adumbamo : Isekuru

Mpagaze ku gasozi nsama ifuro ry'amata : Uruyange rw'amashaza

Mugongo mugari mpekera abana : Urusenge, uburiri

Mutumbagira wa Rujugira : Umwumba w'insina

Mvuye aha nshyutswe ngera iyo nshaka : Amabere y'inkumi

Mvuye ikuzimu bampa akabando : Igikoro

Mvuye guhamba nyogokuru aza ankurikiye : Ivu

Nabyaye abakobwa benshi uwapfuye ijisho muri bo abatanga gusabwa : Inopfu

Nagutera akabaribari kamanutse mu ijuru kaje gushashura abagabo : Ifaranga

Nagutera amazi atemba ajya ruguru : Inzoga mu muheha

Nagutera icyatumye umugabo ataryama : Ifaranga

Nagutera icyo utazi utabonye : Ubuto bwa so na nyoko

Nagutera ikibyutsa umugabo mu gicuku : Ifaranga

Nahinze mu mpinga nsarura mu gapfunsi : Umusatsi

Ndimugufi nahina so : Icyanzu

Ni nde watanze umuzungu kwicara mu ifoteyi? : Ivunja

Njugunye akabuye ku karubanda baragatanguranwa : Ifaranga

Nkandagiye itafari rimena itegura risakaza inkuru i Burayi : Radiyo

Nkubise ikimuga mbura urujyo : Umusuzi

Nkubise umupira ugera i Ngozi : Ibaruwa

Nkubise urushyi rurumira : Ibara ry'inka

Nkuruye umugozi ishyamba rirahubangana : Umusore wishwe n'inzara

Nturutse hanze mbona umuntu ninjiye ndamubure : Agasongero k'inzu

Nyirabugenge n'ubugenge bwayo : Inzoka mu kugenda nta maguru 

Nyirakaruhura intumwa y'urupfu : Ibitotsi

Nyiramakangaza ngo mutahe : Imbeho ku rugi

Nyiramutarataje abagabo : Ifaranga

Nyirabyuma ndashya umugongo : Urusenge

Nyirandarindari : Inda mu ruhara

Sakuza n'uwo muri kumwe : Ururimi rwawe

So na Nyoko bapfaga iki? : Akayuzi mu rubibi

Sogokuru aryoha aboze : Umuneke

Tuvuye mo umwe ntitwarya : Amashyiga (y'inyuma)

Ubwo twicaye hano haraza umuntu aduhamagare : Ibitotsi

Umugezi wanjye utemba uzamuka : Inzoga m'umuheha (umukenke)

Umusaza Sacyoya agendera ku kabando kamwe : Igikoro

Zana akebo nzane akandi tujye gutara intagwira : Ubwoya bw' inka

Zigaritse amahembe zose ntiwamenya iyo nyoko yakowe : Ingara z'iminyinya

Ziraca inyabikangaga : Inshya z' umutwakazi

Nagutera icyambuka amazi kitagira amaguru : Ijwi

Hagarara hakuno,mpagarare hakurya turate abeza : Amenyo

Hakurya ni umukoki, hakuno ni umukoki : Ikibuno

Mpagaze mu ishyamba rimpa umwezi : Ibarizo

Ngeze mu ishyamba rirahungabana : Inzara y'umusore

Nyirabakangaza ngo mutahe : Imbeho ku rugi

Twavamo umwe ntitwarya : Ishyiga

Mpagaze mu mpinga mpenera ab'epfo : Umubagazi

Mutamu irabyina mu gatabire : Imbwa mu masinde

Uwagaca yaba ari umugabo : Kubuza umuryi kurya

Hakurya urwererane, hakuno urwererane : Ururabo ry'amashyaza

Abakobwa banjye barara bahagaze bwacya bakaryama : Imyugariro

Hakurya mu bihuku : Ibizu bitagira abantu

Nahuye na cya matimbatimba cya maguru umunani kigiye kugura umunyu kwa mirongwitanu : Igitagangurirwa

Ruganzu araguye n'ingabo ze : Igitoki

Karavugira ibuhanika : Ingasire

Ayi napfa nakira, simbizi : Akanyoni yaritse ku nzira

Inka yanjye nyizirika ku nzira uyinyuzeho wese akayishitura : Urutoryi

Rukara aratema umuvumba : Urwembe mu musatsi

Rukara rw'umwami yicarira abagabo batatu : Inkono

Faraziya aceza yicaye : Akayunguruzo

Nkiza ibyo bitoki bya so binsaba inyama : Ibabi by'ibibonobono

Mpiritse indobo ikwira hose : Amagambo yo ku rurembo

Mpagaze mu gahinga nyarira abâ€˜epfo : Imvura

Icyo nsasira ntikirame : Ikawa

Nshukuye urwina sinatara : Igihandure 

Havuyemo umwe ntitwabimenya : Ubwatsi busakaye inzu

Nagutera ruganwa iganira n'abantu : Telefoni

Abana b'Umwami bicaye ku ntebe imwe : Intoki ku biganza

Karatembashyashya : Amazi ku iteke

Hari agate utakurira : Umunyereri

Hakurya duuuuuu, hakuno duuuuuu : Ibiradiyo biteganye

Kamanutse kibarangura no hasi kati, nkaba nzasubirayo ndakambura data : Akababi k'umuvumu

Zenguruka duhure : Umukandara

Nicaye iwacu murika isi : Izuba

Iyo umugabo ageze mu rutopki abanza iki? : Ikivugirizo

Iyo umugore ageze mu rutoki abanza iki? : Inyamunyo

Iki gikunda inshyi : Akayunguruzo

Ariya mabuye ya rubarabara wayabara ukayarangiza : Inyenyeri

Nta kujya mu bajiji utari umujiji : Umugina mu rufunzo

Mpagaze inaha ndasa kwa myasiro I Burundi : Umurabyo

Dore aho so arenga n'ibikote bibi : Ikivumvuri

Inka yanjye yimira mu kinono, ikabyarira mu ihembe : Igitoki

Gakore bakwice : Agakono k'inzara

Nagutera nakwiteguye : Gusitara

Ngiye mu rutoki nsimbuka abapfumu bapfuye : Imitumba

Ni iki cyatanze umuzungu kwambara karuvati : Ikiyoni

Nagiye I Kigali ndi umusenzi ngaruka ndi umuzungu : Igitoki cya kamara

Dombidori : Intore mu rwabya

Dore abakobwa berekana amabere : amapapayi

Mira isupu nkasiga inyama : Ibikongorwa by'ibisheke

Ko twagendanye wambwiye iki : Igicucucucu

Ndya nkurye : Urusenda

Ishime nyoko aratwite : Urwina

Nikoreye isi ntengata ijuru : Inzara n'inyota

Dore mukara yateye ku irembo : Amase

Akari inyuma ya Ndiza urakazi : Akanyana mu nda ya nyina

Mama arusha nyoko kwambarira ubukwe : Ikigori

Njya mu nzu kagasigara hanze : Agatsinsino

Mvuye aha nta iminopfu ndinda ngera aho nshaka : Isakamburira ry'inzu

Umwana wanjye yirirwa agenda akarara agenda : Umugezi

Biteganya bitazahura : Inkombe z'uruzi

Nagutera akazibaziba ka ntibazirikana rubanda bashishwa nabi : Gusaba uwo wimye 

Inka yanjye nyikama igenda : Uruyuzi

Fata utwangushye tujye kuvoma iriba ridakama : Ishuri

Abambari b'I Rurinda bambarira inzogera ikuzimu : Ubunyobwa

Inyana y'ishyanga iratema ishyamba : Agahinda k'umutima

Mfite inka yanjye nyiragira ku manga ntitembe : Amatwi

Zisa zitagira isano : Inkoko n'inkware

Ni iki cyatanze umuzungu kwicara mu ifuteyi : Imbaragasa

Umuzungu atwara imodoka umusatsi uri hanze : Ikigori

Nteye agapira kagera I Roma : Ibaruwa

Magurijana arajajaba I Janjagiro : Umukondo w'inyana

Imana y'I Burundi irashoka ntitahe : Agahinda k'inkumi

Inka yanjye irishiriza mu mishito igataha mu mishito : Ururimi

Inkuba ikubita ikwerekejeho umugongo : Umuheto

Inzu yanjye nayisakariye ku nkingi imwe : Icyobo

Karisimbi irahongotse : Igisate cy'umutsima 

Kamanutse kibarangura no hasi kati nkaba nzasubirayo ndakambura data : Agatonyanga k'imvura

Karaguza indwi katagira n'imwe : Agasuzi

Kirisha amazuru : Umuvuba

Ndaguteruye ndakwesa, urahindukira urandeba : Ubunyereri

Ngatake, ngatature, ngashimire ubwiza kameze : Inyenyeri

Ngira imbehe nyinshi ariko nkabura iyo ndiraho : Ibiganza

Ngira inka nyisasira amahina nkayorosa andi : Ururimi

Ninjye muzindutsi wa cyane nasanze umuzimu yicariye ukuguru : Inkware

Nubatse urugo hejuru y'urupfu : Ubwato hejuru y'ikiyaga

Ruvudukana imbaraga, rukavumera rutagira amahembe : Imodoka

Zishotse zitendeje, zikuka ziteye hejuru : Abavomyi

Mfite abakobwa benshi, ariko uwapfuye ijisho muri bo yabatanze gusabwa : Inopho

Ninjye muzindutsi wa cyane, hari aho nasanze umuzimu yiyunamiriye : Umutego

Ninjye muzindutsi wa cyane, hari aho nasanze umuzimu yikoreye inyama : Isake ifite ibirokoroko

Ko So na Nyoko bameze uruhara, inzoga z'I Bwami zizikorera nde : Igihaza

Byumve uhore : Umusuzi wa so

Nyoko si ukunnya arahurutura : Akayunguruzo

Karadundaraye : Akabyindi k'umushumba

Mfite inka 12, iyo inyota inyishe mfata imwe nkayica umutwe nkayinywa amaraso : Ikaziya ya Primus

Mugongo mugari mpekera abana : uburiri

Mpagaze mu Rwanda ndeba mu mahanga : Televiziyo

Nagutera inyamaswa igendesha amaguru 4 mu gitondo, amaguru 2 saa sita, n'amaguru 3 nimugoroba : Umuntu

Nyangufi arasekura uburo : Ifundi mu murama

Mfite inka yimira mu ibondo ikabyarira mu rubavu : Ikigori

Nyuze mu rutoki abasirikare baramfata : Ibishokoro

Abana banjye bambaye ibisa by'ibitambaro : Imyambi y'ikibiriti

Mpagaze inyuma nibonamo imbere : Kwirebera mu kirahuri

Kirabyataraye : Ikibyindi cy'umushumba

Mama shenge : Umwana w'uruhinja

Ndagiye ku manga Imana nibishaka nzacyura : Umugore utwite

Nagutera urupfu duseka : Kukwanduza Sida

Igira hino ncuti : Ikiringiti

Hakurya ni urwererane, hakuno ni urwererane : Ururabo rw'ikawa

Kwigerezaho yikoreye ibyo atazi umubare : Umusatsi ku mutwe

Akabaje umugabo kamurenza impinge : Ifaranga

Kati parararara, kati pa : Ifaranga ku meza

Nshinze umwe ndasakara : Icyobo

Zagarika amahembe ntiwamenya izo nyoko yakowe : Ibiti by'ikawa

Narazindutse mbona inzira y'umukara : Kaburimbo

Cyasamye kitaryana : Ikiryango cy'inzu

Ko tuvuka ku muntu ukwe ntiduse : Umuzungu n'umwirabura

Ujya kurasa inkuba arabandarara : Kwatsa mu ziko

Mfite inkwi zanjye zumye, ariko nazicana ntizake : Amahembe y'inka

Ayiiiiii, ayiiiiiiii : Umukobwa ubonye iwabo hashya

Nteye igiti gikwira isi yose : Ijambo rya perezida

Tabara Sogokuru bamutaye ku munigo : Igikatsi

Nyuze mu nsi y'urugo bamfunda ibirozi : Ibiboga byagaze

Nyiramikuku arakukuza mu mikuku ya Shyorongi : Igiheri mu ruhara

Bihu byumye arenze urugo : Ikiyoni

Nyiramakaraza imana y'i Karagwe, aragiriye ku ishyamba : Ikirungurira

Mpagaze ku ruhiza nyara i Buriza nti Bahinzi nimuhingure : Icyumweru

Kambaye inkonya katazi iyo zavuye : Uruhinja

Nzamutse umusozi ndizihirwa : Umugore ujya iwabo

Jugujugu matenbe : Inyundo

Nyiramariza ari mu mpinga : Indabo z'amashaza

Maguru mane ahagaze kuri maguru mane ashaka maguru mane : Injangwe ihagaze ku meza ishaka imbeba

Bwenge bwa none bwagutana : Kudashyira ingasire mu masaka ngo iyasye

Fata akebo mfate akandi tujhye gitara intagwira : Ubwayo bw'inka

Kacira bucece : Icebe ry'inka

Ni iki cyatanze umuzungu kugenda mu ivatiri : Akanyamasyo

Nyirabyuma ndashya umugongo : Inkono ku ziko

Mugongo mugari mpekera abana : Urutara

Urira rubariro ubone ishyano : Uburiri bw'umwami

Mpagaze ku rutare mpamagara Majigo nti amata y'abashumba yabuze : Umugono w'ishashi

Ndakubise ndirahira nijye mutware wa Mburamatare : Gusitara

Natumba naturika ni ibuye rya Kagbayi : Ishapure n'amasengesho

Mukore ubone : Umwana w'umwami

Kanjengereje karakanyagwa : Ivunja mu kirenge

Rutinduka yitabiriye guhamba umuturanyi we : Gutara ibitoki

Nyamara naza nkaguha amahoro : Ibitotsi bya mu gitondo

Yankamiye mu kitoze, angaburira ibiryoshye  : Ibiryo biri mu nkono ifite imbyiro

Mpa umweru wanjye ngabire abana : Amata

Inyundo za bene Ntwari bazikubita hasi ntizimene isi : Ibinono by'inka

Inkera y' I Busasamana bayirara ku manywa : Isoko

Nagutera uruhehe rudatokorwa : Sida

Ijisho ryanjye rimurika hose : Izuba

Rutuku mu gitebo : Umuzungu mu modoka

Hari ikintu, uretse wowe n'abandi baragikoresha : Izina ryawe

Nabonye umugenzi ku nziga ebyiri : Igare

Ngeze mu nzira mfunga feri : Gusitara

Ninjye muzindutsi wa cyane nabonye imodoka y'amaguru abiri : Ibirenge by'umuntu

Ninjye muzindutsi wa cyane nabonye inyamaswa y'amano 10 : Amano y'umuntu

Nagenze amahanga, Simbona igiti gikora idosiye : Ikaramu

Fata umuhoro mfate undi tujye gutema ibidatemeka : Amazi

Fata Intorezo mfate indi tujye kwasa ibitaswa : Urutare

Karibarangura ku rutare : Inda mu ruhara

Ntiwigore ndaje : Ipikipiki

Nkubuze sinabaho : Umutwe

Ndumwe nkatunga benshi : Imana

Kirarumbaraye : Igisozi kirekire

Nkeje Umwami wo mu kirere, angabira ibiryoshye : Inzuki

Ngeze iw'abandi bampa induru : Sone yo ku irembo

Ibiti byanjye byaka bidacika : Buji

Aho Mutara na Mutaga barwaniye, nta cyatsi kizahamera : Uruhara

Akamanimbanimba,ingoma zo kwa Magagi zivuga zinihira : Inyundo mu ruganda

Mfite icyumba gihora gikonje : Firigo

Ngwino unkize igisebs cy'umufunzo : Umuturanyi mubi

Kiribwa kidahingwa : Inyama

Rwakajwiga arira ku nkomo : Imbwa ishumitse

Mfite ibuye rimena irindi : Inyundo

Karatemba shyashyari : Amazi ku iteke

Dore isoko idakama amazi : Amarira mu maso

Nagenze henshi mbura incuti : Urupfu

Mpagaze hasi umutwe nywukoza ku ijuru : Igisenge

Barahinga nkabarusha ihirwe : Inyoni

Aho ndaye n'aho ngeze mpasiga umwanda : Amase y'inka

Inkoni yanjye nyibyaza amazi, nashaka nkyibyaza amabuye : Igisheke

Nyangufi arasekura uburo : Ifundi mu mamera

Icyanzu cyanjye ngicamo nkafunga : Indumane

Nyirakamana akera inkera atatumiwemo : Umuvumbyi

Nahuye n'uwiruka atagira iyo ajya : Umusazi

Ngenda gahoro ariko nzagerayo : Igikeri  

Mvuka mbagwa, nkakura mbagwa, nkazapfa mbazwe : Insina

Agenda neza nuko yanga abanjye : Intare

Twavukiye rimwe ariko ntitureshya : Imisozi

Nteye igiti nsarura amabuye : Iteke

Imyuko yo kwa Mahanga iruka umuriro : Imbunda

Ntoye ibyondo nsiga amenyo arabengerana : Corogati

Yanze kuza turi bujyane : Imodoka yabuze lisansi

Mpeka nanjye naguhetse : Igare rigeze ahazamuka

Naraguhetse ntiwampemba : Indogobe ishaje

Akana kanjye kabyina neza : Inyana y'umutavu

Twaraye ihinga isuka iramungwa : Isahani yaguye ingese

Wanga wemera ndakujyana : Akaguru gacumbagira

Nshoye imwe nkura ibihumbi : Impeke y'uburo

Mpambye umwe nzura benshi : Amashaza

Kirihura nk'ikitagira amaso : Imodoka yabuze feri 

Kinyuka inabi, cyanyuka ineza nkizihirwa : Imvura y'itumba

Kinyuka inabi, cyanyuka ineza nkizihirwa : Izuba ry'impeshyi

Ntuye heza njye ngira Imana : Umugina wo mu gishanga

Kigenda cyane kitagira amaguru : Umuyaga

Kamana iteka yambara neza : Ururabo

Nahuye na Rugondo arebesha amaso ane : Umuzungu wambaye amadarubindi

Hunga gahinda ataguca umurundi : Inzoka

Ngenda bwangu nkogoga amahanga : Indege

Gitare n'iyayo birakina : Ijuru n'ukwezi

Giteye isusumira : Uruzi

Mutamu irarembera mu bisi n'iyayo : Umuyaga mu muyange

Gaju irashubera mu mukenke : Umuyaga

Gahete umugongo gahetse abana umunani : Umuheto n'umwambi

Gahanitse ari keza : Inyegamo y'umusore warongoye

Dusetse tuzanduranya : Umuporisi

Ndundu hejuru ya ndunduguru : Ingufuri hejuru y'isanduku

Dore iryo shyamba ritabona : Umusatsi w'intabwa

Kana kanjye ngwino nguhe impamba : Umunyeshuri

Wambazaga ibyo uzi kubera iki? : Umwarimu

Inkongoro ya Dede ayinyweraho wenyine : Umwobo w'inzoka

Kabutindi yantuye intango atari busomeho : Umurozi

Nyagiwe n'imvura imbuza guhinga : Amacandwe y'incira

Njugunye igihaza gihinguranya amarembo : Umupira mu izamu

Kora aha : Umukinnyi utsinze igitego

Kora aha : Umunyeshuri wabaye uwa mbere

Nciye inkanda mpirika n'inkingi : Urukoma n'insina

Amazi yacu arusha ay'ahandi kuryoha : Amata

Ubutaka bw'iwacu turabuteka : Ifu