Abagwabiro bashinze inteko : umucaca

Abakobwa banjye babyina bose : imirya y'intanga

Abakobwa ba Ruhinda baturutse ikuzimu bambaye inyonga : insina; amateke

Abakobwa beza baranaga amajosi : urugori rw'ibishyimbo

Abambari ba Ruhinda bambariye inzogera ikuzimu : imigozi y'ibijumba; inkwana z'amateke

Abambarantama ba Ntaragonda batwara amacumu bayacuritse : imirizo y'inka

Abana b'abarundi barasana bakiri bato : ifurwe

Abana ba mukeba bambaye imigoma bose : ibigori

Abana banjye bangana bose : ifundi

Abana banjye bavuyemo umwe ntiwabimenya : akatsi ko ku nzu

Abana banjye bikwije impindu bose : imirizo y'imbeba

Abana b'iwacu bicaye ku ntebe imwe : intoki

Abana b'umwami baratanguranywa mu ngoma : inshunzi mu cyansi

Abana b'umwami bicaye kuntebe imwe : inkwana z'amateke

Abarezi babiri bahuriye mu iriba : inshunzi z'amata mu cyansi

Abatutsi barebare baturutse i Ruhanga : imvura

Abasore b'i Gisaka barasana bakiri bato : igisura

Abazungu b'i Bujumbura baca urubanza bunamye : imigondoro y'ibishyimbo

Abeza bararamukanya : ikinyamushongo

Agacwende kanjye kabaye kure mba  ngukoreyemo : ukwezi

Agakecuru Nyarudindiri kamanutse I Gacu na Mpanga kikoreye imigoma itanu : umusambi

Agakoni kanjye ka rutigatiga nashaka nagatuma umwami : ingabo y'ubuki

Agakono k'iwacu ni imbungiramihigo : agakono k'amanywa

Agatiritiri kaje kaduruza, kaje kuzatina umugabo : umusore

Aha hari agati kadacanwa : isekuru; intebe; igisabo; imbehe; umwashi; umuvure

Aho ndi aha ndareba muhaha ya Nkoronko : ikigega kirimo ubusa

Aho Mutara na Mutaga barasaniye haracyari ibishishibano : inkwana z'amateke

Aho Ruhondo yabagiwe ntihateze kuzashira ibinure : inkwana z'amateke

Aho umugabo ahinze ntasarura : imbaragasa

Aho wabereye iri wararibonye ? : ubukumi bwa so na nyoko

Aho wabereye wari waterara Muhangiro ? : ikirunga

Aho wabereye wataramye  ku kabuhanda : uburiri bw'umwami

Akababaje umugabo kamurenza impinga : ifaranga

Akabingo nyamwishyigure : ishyari ntiriba rito

Akaguru k'umuringa n'akaboko k'umuringa byaterana byabyara umuyumbu : igihondohondo

Akangaratete ka terera tugende dore umunsi uragiye : igare

Akatagira Inka ntikagire umugeni kagura iki? : agahanga k'ihene

Ak'imitana ak'imitari kararenze mu mpinga : akanyugunyugu

Aka kagabo ni gato kakwirukana so : ivubi; uruyuki

Aka kayira kasiba twashira twese : inzira ijya mu kigega

Aka kagabo kakwica so : agahwa m'urwondo

Aka kariza so : akanyarirajisho

Akari inyuma ya ndiza urakazi? : inyana iri mu nda ya nyina

Akamarimari ka Mparabanyi kaje kamara abagabo gaturutse inyuma y'ijuru : ifaranga

Aka Matama aka Matananya karabwiriza inka mu gikombe : akanyugunyugu

Akarago kanjye kazinze neza : umwumba w'urukoma

Akavumu k'iwacu imbungira-mihigo : akayonga k'amanywa

Akavumu k'iwacu ni mbimbura-mahina : akabehe karagurirwaho

Akayuriyuri ka ntibazirikana inshuti y'urupfu : ibitotsi

Akebo ka Dede kariramo Dede wenyine : umwobo w'inzoka

Akigize umugozi kakigira umuganda kagashyira umwami ku murwa : umuhotora; umuhoro

Ako nateye i Mwonga ntikaravayo : akajyo batereye munsi y'urugo
 
Amabuye ya Nyarubuyenge wayabara ntiwayashobora : ukwezi n'inyenyeri

Amenyo abiri : ibikingi by'amarembo

Ayii! : umukobwa ureba iwabo hasya

Ayii! : igikecuru kimennyeho igisururu

Ayii! : umukecuru wabuze ikijigo cye

Ayii! : umukobwa ureba agacumu kishe musaza we

Bagatake bagasamaze bakabikire ubwiza bwako : imanzi mu maribori

Ayo macumu yose araterwa ingabo za Ruhende : ifundi

Bagiteye icumu gicumba umwotsi : ikinyugunyugu

Baguha akabando urwaye iki? : igikoro

Bakaribata n'umuhungu we Bajogo : igikona

Bakobwa nararushye : akagabo ko mu irebe

Bandasa bandamira ny'ir'imoso ndi imanzi : igihumyo

Banga ingata mbange indi tujye kwikorera ka kaguru ka Dondi i Budaha : ukuguru kw'imbaragasa

Barateka ntibaminina : amazi y'inyama

Barugerageze barugere imigozi barushyire hagati y'abagabo : intore n'umutsima

Bantetere anyuze aha : umugore utwite

Behu behu!!! : umwironge

Bibiri ngo piii : imvura ku iteke

Bicinyigiri bya Bikangaga Bikondo byacuzwe n'abantu : ibirago

Bihembyiheru imfizi ya Bigutu : imiduha

Bihogo bya Birahinda ntitanga iratiza :  Imana

Bihubyumye arenze urugo : igikona
 
Bikumburanye bibana : amabere-igikingi by'amarembo

Birigita birigita : imende ku mugezi

Bikumburanye bitazahura : isi n'ijuru

Birasa ntibitana : amabondo y'ihene

Bisa bidasa ururo n'urumanfu : amasaka n'urukungu

Bireke bifurize : inkari mu murama

Biromongana mu mpinga ya Janja : ibicuma ku nkangara

Bisa bitagira isano : uburo n'urumanfu; amata y'inka n'ay'intama

Bitamba araguye n'ingabo ze zose : igitoki n'insina bigwanye

Bombori bombori : urujyo ku nkoko

Bucunya butisiga : ubuzuru bw'imbwa

Buhiri bwa Kamango yakubitaga so amuruta : uruyuki

Bune bune yagiye kugura umwenda kwa mirongo itanu : isekurume

Bwira Rugango uti, "Rugahura aragusize" :  umutsima n'inyama

Bwiza bupfuye ubusa : uruhu rw'imbwa

Byagira biti, "po!!!" : imfizi y'intama

Byakora kurya, byakora kuno : amara

Byumiye mu gasozi : amabyi y'umushumba

Ca bugufi baragosora : ifundi mu murama

Ca bugufi turase Bigungira : umugunguzi

Ca bugufi turase Rugingira : ifundi ku rukoma

Cyagize amenyo cyabamaze  : nyankari

Cyakwica cya Mburamatare : insitare

Cya mbiri mbiriri cya mwiza wa so : igiteke mu nkono

Cyamutimbatimba cya ngoma y'abatindi : igitoki n'amakoma

Cyamusamasama cyamunumanuma inka z'umwami zirasana zirahira : ikiyiko ku mbehe

Cyasamye kitaryama : ikiryango cy'inzu

Cyatanze umuzungu kwambara karavati : igikona

Cyimitse ingere gihetse Rwigema kigiye gusumba Tarasi umwami w'i Gisaka : ikigori

Dadari dadari : inda muruhara

Data aranyishe data wacu arankiza : ibuye ryica isuka irindi rikayigorora

Dimba ikwege : ikiba cy'ubwatsi

Dore ibitoki bya so ngo biransaba inyama : ibibonobono

Dore ibyo bibuno bya nyoko ngo birurira uburiri : igisabo

Dore ibyo bigutu bya so ngo birarenga urugo : ikivumvuri

Dore iryo shyamba ritabona : umusatsi w'intabwa

Dore urujya mugabo urimbana impuzu mu mpinga ya Kinyinya : ikinyabwoya

Dupfyunye tudupfyunyike bene urugo bataraza : udukongorwa tw'imisigati

Fata agahini mfate akandi tujye gusekura umutanoga : umusenyi

Fata agakono mfata akandi tujye guherekeza Nyamuhirimanga : umugore utwite

Fata akebo mfate akandi tujye gusoroma intagwira : ubwoya bw'inka

Fata ingata ngukorere sangara : agakenya kw'imbaragasa

Fata inkoni mfate indi tujye gukubita Rutabyuka ku Mukobwe : igihu

Fata inkoni ngufi turagiye ku manga : umusigati

Fata kagina tuyirase : urugo

Fata sogokuru atagwa mu ruzi : umucaca

Fata so ndongore nyoko : ishoka mu giti

Fata ubwato mfate ubundi tujye kwambutse ibitayega : umugore utwite

Fata umuhoro mfate undi tujye gutema ikidatemeka : umuzi w' urutare 

Gacika gasubiraho : urwara

Gacika kabaho : umusatsi ; urukangaga

Guhirima aguye i Buheza : intore y'amahingura

Gaju iriruka ntirenga : umukenke

Gakore bakwice  : agakono k' inzara

Gakubise ngaru gaca mu masaka gasama Kigeri : agafuni kabagarira amasaka

Gakubite ugakubiranye : agakono k'amapfa

Gashinze i Gasebeya : akarizo k'ihene

Gatuma irabyina mu gatabire : ikibwana cy'imbwa mu masinde

Gatitiba ihetse kabutindi : umuzungu ku ipikipiki

Gaturutse ikuzimu gashyushye : akana n'insina

Gatukura katokeje : umwana w'ifundi

Gihegege mushiki wa Ntare : akabeba mu buki

Gihe umunzeri : umuhinzi umwe mu murima 

Gikubise  Ngaru kubuguza ingabo : ikigore kivuye mu mazu kenshi

Gikubise Ngaru kigaruza Ngaruye kiraza gishyatama aho : ikigore cy'ikiva mu nzu

Gishyuha kitotsa : umusuzi

Gitembe ucyegure : ikiba cy'ubwatsi

Gitsimba igiheneko : igitama cyaguye mu mukokwe

Gituku my gitebo : umuzungu mu modoka

Guhora mu murima si ko guhunika ibigega : umusambi

Hagarara hakuno mpagarare hakurya duterane ibidashyika : ibipfunsi

Hagarara mu itahe najye mpagarare mu itongo : intashya

Hagarara mu mpinga uhagaritswe n'umugabo utakuruta : imbaragasa

Hagati ya Gacu na Mpanga hazi bake : uruheri mu gihata

Hakurya hena, hakuno hena : abagore babagara

Hakurya mu gihuku : ikizu kitarimo abantu

Hakurya ngo dondi no hakuno ngo dondi : abakomyi b'insyo

Hakurya no hakuno ngo barubaru : urubura mu masaka

Hapfuye Senkopfu hasigara Semfunda : imigondoro w'ibishyimbo

Haruguru ziraterana ay'imbogo : amahururu y'ababi

Hepfo aha hanyuze impehe : inzuki zitagira urwuri; inka zidafite imfizi

Hepfo aha rurakubana : umusaza cyangwa umukecuru n'agashyitsi

Hepfo isanane haruguru isanane : amano y'inanga

Hepfo macibiri haruguru macibiri : amabondo y'ihene

Hepfo nyagakambwe na nyagakecuru barapfumbatanye : igishyitsi cy'umusave n'umubirizi

Hepfo rurakururana : impatwe z'umusaza

Hepfo zirabyina urungora : urugoyi rw'ibishyimbo

Hi hi hi! : igikecuru cyisutseho igisururu

Hirya hariya hari imizo n'iminzenzi : isogo n'inyabutongo

Hirya harahiye no hino harahiye hasigaye  urukumbi rwa Sasa : inzira

Hirya nakubira no hino nakubira : amabondo y'ihene

Hirya y'ishyamba Hari agashahura abagabo : umusoro

Hirya umuganda no hino umuganda : ururimi hagati y'amenyo

Hita i Nyarubuye mpite mu Mbiyo tuzahurire i Nyanza : urubariro

Ibikaci bikaciraniye muri Nyagafunzo, ibisiga bizapfana umukumo : amabere y'inkumi

Ibitugu bya so birarenga urugo : ikivumvuri

Ibuka hakurya : utuzu tw'abashumba

I Burundi n'i Bunyabungo inama ni imwe : inkono ku ziko

Ibuye ry'imusozi ryimuye umugabo : ifaranga

Icyambuka uruzi kitagira amaguru : ijwi

Icy'ubwoya icy'impwempwe cyagarika impanga mu mpinga ya Bwanacyambwe : umwungu mu ncoce

Idodorido : inda mu ruhara

Ifuni iracoca urukoro : ikinwa cya Nyirabarazana

Igagarigaga : inda mu ruhara

Igiharamagara kitubereye mu ruhara : urugi

Igihondohondo cy'amaguru munani : ikigega

Igihugu cyose Iya bitatu : amashyiga

Igira hakurya nange nigire hakuno duterane injunguto z'imiseke : urubura

Igire hino ngusekere : amashaza akaranze

Igira hino nshuti : ikirago; ikiringiti

Igira inyuma y'inzu bagupfunde ibirozi : ibiboga bigaze

Igira inyuma y'inzu uce y'umuze n'umunzenze : urusogo n'urusogi

igira inyuma y'inzu ukube ino : imigondoro y'ibishyimbo

Igira inyuma y'inzu ukubitwe n'inkuba : kubona aho nyokobukwe yiyuhagira 

Igira inyuma y'urugo nkuvumburire impongo itagira umurizo : umubuyenge w'intosho

Igira mu mpinga wibuke uwo mwajyanye : ubuheri mu gihata 

I Gisaka ntibacinyira bangana amacinya : amenyo

Igishorankwanzi cyamanutse gihora gikwiza ab'iwanyu bose imigoma : ikigori

Igitabo cya Mutara ntawutagishengera : ikibuguzo, igisoro

Igiteye imbabazi : ikibwana cy'imbwa

Igiti kiguye i Nyanza tugikwirwa amashami twese : ijambo ry'umwami

Igiti kinini ruhumbanyoni : inkono ivugirwamo umutsima

Ihirike naraguharuriye : imodoka mu muhanda

Ijoro rirara hehe? : mu murima w'inkoko

Ikibyoya ikibyanwa mu mpinga ya Bwanacyambwe : icyugu mu nshoce

Ikigira izina ntikigira ibara : umuyaga

Ikiri aho nicyo kiri i Burundi : ipfundo ry'urudodo

Ikitagira amaraso : igishorobwa

Ikiyongoyongo cya Nyirabayogoma kiruka ikijya epfo n'ikijya ruguru : umuriro, umuyaga

Iriboneye ntiritica : ibere ry'inkumi

Iri waribonye he : umurara w'uburo

I Mabara zirarabagirana : impururu z'umutindi

Imana y'i Burundi irashoka ntikuka : agahinda k'umutima 

Imana y'ishyanga irabagira mu ishyamba : ishavu

Imanika mahahara imanura amahano kwa mfura zitarya : inzugi z'imigano, umukokwe

Imbehe za Nyirabangana zingana zose : isi n' ijuru

Imbere ndi imanzi, inyuma ndi umwanzi : ikinyagu

Imbere ndi imanzi n'inyuma ndi imanzi : icyansi, akanyita k'uruhu

Imikara y'i Gasangi irabira rikarenga : igikona

Imikorere ya Nyiranzana nagize ngo ibiryo bye ntibizaribwa none ndatora n'urwo hasi : inzuki n'ubuki

Imisozi irahiye hasigaye rukumbi rwa Shaza : umugina, inzira

Imisozi irashika ibikanu : abahizi

Imisozi irashya Rukaba yo ntishya : urutare

Imisozi iriyorosa ibigondo : ibihu, inzuki

Imisozi yarahiye isiga inkuba n'imiheto: igitare

Imivumu y'iwacu ni ruhumbanyoni : inzara

Imparakajosi ya Nyamujyana, impara ironsa batanu : umuheto n'imyambi

Impeta Kajiga ya Rujinja ironsa umunani : injishi y'igisabo

Indigitagitaka intahira y'urugo : ikijumba

Ingabo yanjye yuma ihagaze : urusenge

Ingobyi ngari ni yo impekera abana : ubwato

Ingurukira y'umuvumu yameze mu kivure : urusogo mu Mukobwe

Inka yanjye ishiturwa n'abagenzi : igikona

Inka yanjye irishiriza ku nkombe ntitembe : akanyoni karitse ku nzira

Inka yanjye irishiriza mu mishito igataha mu mishito : ururimi

Inka yanjye ndayibaga igakwiza abagore banjye bose inkanda : ikigorigori

Inka yanjye yahindutse umwirungu : igiko gihiriye mu ruhura

Inka zanjye zaragiye zigaruka mu mpinga y'abankunda : umuyaga 

Inka zanjye zaragiye zirarima zirarimagura : inda mu nnyo

Inkongoro ya Dodo inyweramo Dodo wenyine : umwobo w'impiri

Inkota y'ishyari irahigira mu ishyamba yonyine : agahinda ku murima

Inkuba ebyiri zihindiye i Bwishaza : inzuho ebyiri mu ntango

Inkuba ikubita ikwerekeje umugongo : umuheto

Inkuba ikubita ku butaka ya Rujinja abayimira : ikijumba 

Inkuba irarenga : Isha mu ibanga

Inkuba-rugo : inkangara

Inkuru nziza ivuye i Burayi : inzara y'uruhinja

Ino karahari n'i Kongo karahari : ifaranga

Inshyimbo y'iminsi yegekwa mu mfuruka : uruhindu rw'indushyi

Intukutuku inyamubande : amahundo

Inyabubiri inyabutatu Barbara ntibayishobore : amaguru ya muhuhirizi

Inyabune ya butanu yagiye kwenda inani kwa mirongo inani : imirya y'intanga

Inyabutatu ya butanu ku ngoyi imwe : imyungu ku ruyuzi

Inyagarinyagari bana ba mama : amazi ku rukangara

Inyuma ya Gacu barahima intebu : uruheri mu gihata

Inyuma ya Ndiza urwenge rurahonya : inda mu ruhara

Inyuma y'inzu zirabyina inkora : urugoyi rw'ibishyimbo

Inyama y'urusaku mu rugo rw'imiseke imbere i Nyamagana : ururimi 

Inyumba isakaje inyuma : ikinyogote

I Nyarukomba baratema : ubuheri mu gihata

Inzira ijya ibunyokorome yasiba wahwera : inzira ijya mu kigega

Inzira ijya i Burundi igenda amagorigondi : imyobo y'ifuku urwanwa rw'umuhoro

Inzovu rubunga itaha mu mwobo : ikidasesa

Inzu yanjye nayisakariye ku nkingi imwe : icyobo

Inzu yanjye ntigira umuryango : igi ry'inkoko

Inzu yanjye yuzuzwa n'urubariro rumwe : icyibo

Ipikipiki mu gupiga nyoko wangana iki? : inda mu ruhara

Irengerenge : inzogera

Ishenyi isenya urw'undi ihora mu rwuguriro : umusambane

Isuka irokeye ni yo ihinga neza : ikinwa cya Nyirabarazana

Ishyamba ritanze umwezi : ibarizo ry'ingoma

Iteze neza ntiyica : ibere ry'inkumi

Iwacu duteze ingori twese : umugengararo w'amasaka

Iwacu twikwije impindu twese : imirizo y'imbeba

Iwacu twicaye twese : intebe

Iy'uruvurivundi, iy'uruvurivundi iyo bakubita ivu rigatuma : ikinyugunyugu

Izo ntoki zinsaba ugira ngo ndaziha : imyenge y'inzu

Jugujugu matembe : inyundo y'umucuruzi

Jya mu kirambi wikorere isanduka : imbaragasa mu kirenge

Jya mu mubande ubandwe Kagoro : uruyongoyongo

Jya ruguru tujye mataza : umwishywa ku rutare

Jya Ruhushi imbere tujye gukwa nyina w'urwumvu : icyugu

Jyewe nyirankarago ntabwo nduha akabuno : inkono ku mashyiga

Kagaba arabagira ku ishyamba : agahinda mu nda

Kabatama ku bukoro : ingata mu ruhira

Kabatama i Bukoma : akagata mu rwobo

Kabandabanda mu murima wa Marara : imbwa

Kabindi birima nzagusanga ivomo : igitonyanga

Kabudugu : akadiho k'imbwa

Kabutimbatimba kabunumanuma ku ngoma ya Gahindiro : umununi ku itabi

Kacura bucece : agacebe k'intama

Kadiridiri ka Ndirimba hejuru ya Sandarubeti : umuntu uri ku ipikipiki

Kagaga iri hagati y'urugano : ururimi

Kagaju irasekura umusenyi : inkware

Kagaramiye inzira : agakongorerwa

Kagema ijuru : akumba k'urukoma

Kagera iruje : ikiziha cy'inzovu

Kagenda gatonnye kagera ibwami kagatona : ikinyamunyu

Kahemena : akotsi k'abatabazi

Kahwekera : agahoro mu ntoki

Kajugujugu ka Kamarankoni : uruyuki

Kakubagurira : akanyita k'uruhu

Kakubagarira : agahinzi kamwe mu murima 

Kakwica kakwigarika akambari ka Matene : agahwa mu rwondo

Kari agahiru kari agaheto kariyereka imbere ya Nkotanyi : umwungu mu mbibe

Kaributumbi kaributurike ino mine Patri Kabgayi : ikirungurira

Karimo muri byo : akanigi mu ijosi

Kari n'imyambi kari n'imiheto karahamiriza imbere ya Sambwe : ikinyugunyugu

Kari n'ikindi karakina mu gikari : akayuki 

Karisha gapfukamye : inda mu mutwe

Karisimbi irahongotse : igisate cy'umutsima

Kamanutse kibarangura : akababi kumuvumu

Kamanutse kibarangura kati, "nkazasubirayo ndakambura data": agatonyanga

Kamanutse kavuga amangara : urusisiro

Kamennye urutare gataha i Mpushi : urukwavu

Kamuhanda ntiwayiterera : akarizo k'ihene

Kaniginigi kaniga amazi karota he? : agashwi k'inkoko

Kanyonyomba : amaraso ku murundi, umugezi utemba

Karabambaje kiradandaje : ikirago

Karabuduriye karabuduriye mu mpinga ya Byimana : intosho mu manga

Karacunda ngwegwe : agaseke mu ruzi

Karaga ati, "pfiii!!!" : agatwa mu ibumba

Karagonda isebeya : akarizo k'ihene

Karaje n'inkonya n'inkweto ntikazi ko ryavuye : agahinja

Karahunda ingabo ya Rujende : agafundi

Karakeba, karamasha : agashyo mu nyama

Karakurizaga karakurutaga waduri we! : akanyarirajisho

Kararima na Mwimanyi : akanyoni gatwawe n'amazi

Karashonda inzira : umuganda 

Karatambana inyama itukura : isake

Karatemba shyashyari : umusaza ku cyahi, amaraso ku murundi

Karatemba shoshori : akishywa mu rutoki

Karatona ibwami : akagorigori

Karavuga indwi katagira n'umwe : agasuzi

Karavuga ruhuma : akamangu mu muvumu

Karavugira i Bumpanika : akagasire ku rusyo

Karavugira i Tanama : inshunzi mu cyansi

Karazigurira : akazizi k'amata

Karekare mu ka karema : umuheha mu buki; agasave mu rutoki

Karenze impinga kannya ibibuye : umuhumetso

Karera dee!! : akaganza k'uruhinja

Karuhura mukuru w'urupfu : ibitotsi

Karisha umuntu kurunga : uruyuki

Kashira amanga karakanyagwa : agacumu kica inkurikirane; akobo kavuna umubyeyi

Kashubera : akotsi k'abatabazi; agati mu ruzi; agakwavu

Katemba igogo : uturaso ku murundi

Katunga ijuru : agahundo

Kati "bambari", kati "ba!": agatonyanga ku kigega

Kati "Jyiii!", kati "izibukire!" : igishyimbo cy'umutura

Kati "kaci" , kati "hwi!!!": agaca mu nkoko

Kati "diri diri, dore umuhamirizo nakuye kwa Mukoze : urukwavu

Kati "mbagira butimbo" : agahanga k'ifumberi

Kati "papari",kati "pa", inzubukira nayikiye kwa Rwamugenzi : inkoko mu kigega kirimo ubusa; imigeri y'isha ku rutare

Kati "papari" kati "pa", mukuru wayo iti mpore : akuho mu ntango

Kati "poo!" Kati " paa!" Mukuru wayo ati "reka!!" : akabuye gahonze isuka akandi kakayigorora

Kati "pyo!" Rugamabara ati "ndaje" : amata n'umutsima

Karatona ibwami : akagori

Katurutse i Bujinja : agatsinsino k'uruhinja

Kavuye aha kabatinatina kagera mu gahinga kakibatinaguza : umusoro

Kayogoyogo mushiki wa Ntare : agaheha mu gacuma

Kazikure irya, kazikure ino kati "Ni izanjye na Runana" : umununi ku gicumucumu

Kenyera tubyine urumasha : agafuni mu mushike

Kera imbere kakirabura inyuma kagatona ibwami : igitoki

Kera tukiri abambari b'umwami twavugirizaga amayugi ikuzimu : ibirayi bikiri mu gitaka

Kibamba imennye urugo : umucaca

Kibindigiri ngo zinduka tujye ibwami : irobe

Kibuguje i Ndorwa kigarura ingabo kigeze mu mpinga gishinga feni : ikigori

Kibwete ahise hariya : umugore utwite

Kirimbakweri : ikiba cy'ubwatsi

Kidimba cya Muragi umwana w'umuganda ntawe utamugira : inkono y'itabi

Kirigita ikinogori : isuka mu icukiro

Kirimba kiva i Nduga nafatiye masunzu mu masumo ya Rusizi n'ubu ndacyahirimba igitutu : ifi

Kirisha amazuru : umuvuba

Kirya ni iki? : igitsure cya mukeba

Kigaruje ingogo kigaruje ingabo kirashaje ku nyanja y'i Karagwe : ikigori ku nzira

Kimenyi w'amenyo abiri : ibikingi by'amarembo

Kinigirije umugara mu mpinga ya Rusoro : inopfu

Kino si igisebe ni myambi : igikuku

Kiracunda runete : imirizo cy'intama

Kirahara dudu : inuma mu kigega

Kirashoboka i Rutonde : inka mu mpinga

Kiravunja umukenke : ikibyindi

Kiremankwashi cya Nkwakuzi nkubita icyara ngukubite ikindi nyabusa we : intare

Kiti "tiku", kiti "dumburi", kiti "databuja nkumbuye i Rwanda : umusemburo mu kibindi

Kivuye i Nduga kiririmba : ikirizo cy'intama

Kiza abayumbu ku rugo : imiyenzi

Kizuye umugara kijya kubaza iyo kizatabaza : ikinyabwoya

Ko dutamiye twese hakije nde : imyashi

Ko mwiruka muvunnye nde? : isuri

Ko uri mukuru wa kera wari wabona ishinya ya Dede? : ishinya y'urushishi

Ko uri mukuru wa kera wari wabona umwami w'amenyo abiri? : ibikingi by'irembo

Ko uri muremure wakama ibere rya Rwego? : icebe ry'imbaragasa

Ko uri umuhanga wo kurasa warasa indonyi : inshishi

Ko urusurumbira uzarwambuka? : umucaca mu ruzi

Kuba ahirengeye si ko kwumva : agasongero

Kuba mu gisiza ntuhinge uburo ni iki? : umusambi

Kuba umurenzi ntushengere i bwami : igihondohondo

Ku irengerenge ku ididiri ingoma : inyundo z'abacuzi

Kubira so hepfo mukubire haruguru tumwite Rwabuzutu : umuyaga

Kujya mu bajiji wari umujiji : umugina mu rufunzo; umwishywa mu isusa

Kuki inkuba ikubita uri inyuma y'umusozi ntiwumve? : inzu iguye

Kuki ujundika inyama ntuzimire : ururimi mu kanywa

Ku ngoma ya bidiri ngo di : urubura mu makoma

Kurara ubuzima ufite inkwi (imyase) ni iki? : amahembe y'inka

Kwa Bucondo barakocagurana: urusyo n'ingasire; igikona n'umutsima; imbwa mu magufa

Kwa Rwangeyo icyumweru : igifu

Keishongora cyane si ko kujya ibwami : umudwedwe

Kwumva menshi kagahishira : agafundi ko ku nzira
 
Maganyiro : inkingi yo ku musego

Maguru aca inkanda nyirashyano : amaguru y'umusambi

Maguru ijana kabuno kaboze, hembe rimwe : inzu

Mahuhu hakurya : inzu irimo ubusa

Makasi ihuye n'indi : ibuye n'umutarimba

Mama Arusha nyoko gukimbagira inkanda : inda mu ihururu

Mama arusha nyoko amabuno : intembatembe

Mama arusha nyoko ibikinga : uruhiza

Mama arusha nyoko kunogera inkanda : umusambi; ikinyabwoya

Mama arusha nyoko kuzinga inkanda : umwumba w'urukoma

Mama arusha nyoko kwambarira abakwe : uruhu rw'intama

Mama arusha nyoko kwambara inigi zera : icyiyone

Mamahinda mamahi : amahinda y'inkuba

Mapfumfuramanyoni : amahembe y'inyama

Matama wa vure : ikirago

Mabanda imbaragasa : ikinyoro mu rubavu

Mbe muganga aho wicaye  nturuha akabuno : inkono ku ziko

Mbindigiri agiye i Nyanza : irobe n'umutsima

Mbonye inkoni nziza mbura inzira ngo njye kuyica : kudashobora kurongora mushiki wawe

Mbonye umusore w'i Gisaka asomera igisate cy'umutsima : umurabyo

Mbyutse kare mbona umuzimu mbaye intorezo : imbwa ifite igufa

Mennye inkuba nyihambiriza Indi : igitoki n'amakoma yacyo

Mfite abakobwa kuva ku ngoma ya Gahindiro n'ubu ntibararamukanya : inkombe n'uruzi

Mfite abana bakicara ku ntebe imwe : igitsina cy'amateke

Mfite abana nkabasiga nkabanogereza  nkabasubiza mu nda : imyambi mu murana 

Mfite abana ntiwababara : uburo

Mfite abana ntiwamenya uwavutse mbere : ibishyinga

Mfite ibiti imizi yabyo yakuze ijya hejuru, amashami yabyo areba hasi : ubwanwa

Mfite igihugu cy'abagabo gusa : ibigori bifite imisatsi

Mfite ihene aho iziritse ntawe uhita atayiseguye : umunyinya

Mfite imfizi y'ihariye ishyanga rya yonyine : agahinda mu murima

Mfite ingungu ebyiri zinyambutsa uruzi iteka : amaso

Mfite Inka nirusimbuka migina : imboni

Mfite Inka yica ikiri nto : isovu

Mfite umwana akarara aryamye akirirwa aryamye : ikirago

Mfukumfuku yatura so ku mucaca : umusemburo

Minyaruko aranyarutse  Ruganzu ati "ndindira aho" : igikona n'umutsima

Minyaruko ati "hi!", Rugamba ati "narakaye" : intore n'amata

Mpagaze aho ndora amenyo ya Ruganzu : ibikingi by'amarembo

Mpagaze hano nkubita inkoni yanjye i Buzi : umurabyo

Mpagaze ku gashyinga ndashyenga : inkware

Mpagaze ku gasozi mbona abagore bambaye impeta bose : uruyange rw'amashaza

Mpagaze ku gasozi Mpanga amatama nti amata y'abashumba yabuze : umwumano w'ishashi

Mpagaze ku gasozi ndasa Rugina mu bihaha : ikigega kitagira amasaka

Mpagaze ku gasozi nti "bahinzi baho baho" : intuku z'amasaka 

Mpagaze kugasozi nti "bana banjye hubika" : amahindu mu mateke

Mpagaze ku gasozi nti "bana banjye murizihiwe" : amasaka y'umuterero; insina zikaragiye

Mpagaze ku gasozi nti "behu" : abarinzi b'inyoni; inzara mu bana

Mpagaze ku gasozi nzana ifuro ry'amata : uruyange rw'amashaza

Mpagaze ku manga Imana ibaza impa : umugore utwite

Mpagaze ku rutare ndasa umwambi umara abana b' abatwa : inzara

Mpagaze mu gahinga mbona Rukara mu kabande : icyiyoni

Mpagaze mu mpinga ndizihiza : umwuho w'amateke

Mpagaze mu gahinga mbona Rusengo mu maraka : inkono itogota

Mpagaze mu irembo mbona Bukoramungabo mu nda : ikigega kirimo ubusa

Mpagaze mu mpinga ubutogore buramvuna : umugabo wambaye umwenda mushya

Mpingira mu misozi yase ngasarura mu gipfunsi : umusatsi

Mpise kwa Rucuku bakocagurana : ifuni mu mabuye

Mpuye n'Imana yikoreye inyama : isake

Mpuye n'Imana yikoreye intebu : ipfupfu ry'impfizi

Mpuye na Mugara : ikinyabwoya

Mpuye na Ruganzu yikoreye igitebo cy'intama : ibisunzu bya rusake

Mubikombe ngo, "gi!" : umuhazi ugwanye umuguta

Mu bikombe ngo, "hobeka" : umujugujugu mu ihene

Mugarika ayera ni Sebatongo : umuyenzi

Mu gikombe ngo, "hobe-hobe!": uruheri mu gihata

Mugongo mugari mperuka abana : uburiri; urusenge

Mukara ikamwe ayera ni Inka ya Dogo : umuyenzi

Mukara n'iyayo : inkono n'urweso

Mukara w'i Karambi irabira rikarenga : icyiyone

Mu kwidumbura wari mwene Nyakwidumbura : inkota mu bitugu

Mu mucyamo biradogera : impatwe z'umusaza

Mugina ni uwa Muko : imutsi wo ku kibuno

Mu nzu umu tuboze ibibuno twese : inkingi

Murace inkoni ngufi turagiye ku manga twese : ingingi z'amasaka

Murarajuru wa Rujugira ntagikoza ibirenge hasi : umwumba w'insina

Mu rugo rw'imiseke hagati Nyamagana : ururimi mu menyo

Musatsi murende umukobwa utagira inenge : urufunzo

Mushenyi araguye n'ingabo y'umuyobe : igitokd kigwanye n'insina

Mushenyi iti "Jya", Rwagashya ati "ndinda" : inkuba n'umurabyo

Mutamu irarenze n'iyayo : isha mu mukenke

Mutamu irarenze n'iyayo : isha mu mukenke

Mutamu iriruka ntirenga : umuyaga

Mutimbo araguye n'ingabo ze : insina

Muzane akwuho mbahe agakoma : ugutwi kw'imbeba

Muze tumupfyunye bene umupfu baraje : icyagumbwa

Mvuye aha ncumbagira ngera iyo nshaka : uruboho

Mvuye guta nyogokuru aza ankurikiye : ivu

Mvuye i Gisaka nsomera igisate : inzara y'umusore

Mvuye ikuzimu mpinnye agatoki : umugondoro w'ibishyimbo

Mvuye ikuzimu nkinze ingabo imwe : igihumyo

Mvumbuye inyamaswa itagira umurizo : intosho

Mvugirije ingoma ikuzimu abaribi musozi barayumva : agakono k'impengeri

Mweru n'iyayo : urusyo n'ingasire

Naba aha nakugeta : imbaragasa

Nabusobeka ntiwabusobanura : amata n'amatezano; Mukungwa na Nyabarongo

Nabyaye abakobwa benshi umubi muri bo abatanga gusabwa : inopfu

Nabyaye abana ariko ntiwamenya imfura muri bo : amafundi

Nabyaye umwana, ariko mubandi bana niwe mpora njya guta : umusatsi

Nagukubira dara : ibiryo ku mbebe

Nagutega icyatanze abazungu kwambara ingofero : igihumyo

Nagutera agasaza kakiri agasore : ifundi

Nagutera agatsengenetse : akanyoni karitse ku nzira

Nagutera aho uzikundira ntuhatahe : k'umutima w'undi

Nagutera akabaribari kamanutse mu ijuru kaje gushahura abagabo : ifaranga

Nagutera akabyara katimye : insina

Nagutera akakuriye mu murama : akana kavutse kadashyitse

Nagutera akarya ntikannye : ikirondwe

Nagutera akambuka uruzi katarubonye kandi katarukandagiyeho : umwana uri munda ya nyina

Nagutera akatagira ingingo : agasuna

Nagutera amacumu yacuzwe n'intoki : amasuka

Nagutera amakara y'umuntu : umusatsi

Nagutera amazi ajya ruguru : amazi mu muheha

Nagutera ba Manzi bitwaza amacumu bayacuritse : imirizo y'inka

Nagutera Byuma bya Bihigina byacuzwe n'umuhanga : intorezo

Nagutera cya mutimatima cya mutima w'intomvu cyubatse ku itongo : ikirungurira

Nagutera Cyurweru cyambaye umwenda kwa Rwangeyo rwa Makombe : urume ku musororo

Nagutera ibisakuzo bya Nyirasapfu : amafuni mu rukoro

Nagutera ibumbabumba : umutsima; intosho

Nagutera icy'ibyoya icy'ibyanwa : umwungu

Nagutera icy'ibyoya icy'impwempwe : ikinyabwoya

Nagutera icyika kikambuka : intorezo

Nagutera icyo utazi utabonye : ubukumi bwa so na nyoko

Nagutera igucutsa kitagira amabere : inkoko

Nagutera igisumba ngari : ururo mu mateke

Nagutera igisogo nyamutentema : umuziha w'inzovu

Nagutera igitutsi kimanutse kwa Rwatangaho cyiteye imigoma itatu : ikigori

Nagutera igitutsi kirekire cyamanutse i Muramba : igitonyanga

Nagutera ikatakata ibumbabumba, akantu kangana urwana rw'umuhoro : intorezo; urushishi; intosho

Nagutera ikigira inyama ntikagire igufa : ikirondwe 

Nagutera ikigira izina ntikigire ibara : umuyaga; umusuzi; amazi

Nagutera ikikakika : umuhoro

Nagutera ikirya byose cyanywa amazi kigapfa : umuriro

Nagutera ikimenyimenyi mu biga bose : ikizamini

Nagutera ikiruma kitagira umunwa : igiseke

Nagutera ijigija y'igihugu wayimenya nkabgu nkaguhemba : isuka

Nagutera ingingo ikeba amazi : uruho

Nagutera ikivuga kitagira umunwa : ingoma

Nagutera Imana y'ishyanga ibagira mu ishyamba : agahinda ku murima

Nagutera imiringa magana atanu bizira gutira : amasaka

Nagutera indishyi y'urupfu : umugore uhetse

Nagutera intobo ruyumbu : ijisho rya mukeba

Nagutera Inka irisha mu ishyamba ryayo ryonyine : agahinda ku murima

Nagutera inkangara ya Makaci batera icumu igakinga ikibaba : umugore unnya kugihuru

Nagutera ishongashonga nagutera ikikakika nagutera akantu kaba iwanyu wakemenya nkaguhemba : ishenyi n'intorezo

Nagutera inyabutatu ya butandatu : injishi z'igisabo

Nagutera Mugemaguru wa Rujugira wamumenya nkaguhemba : inyenyeri ku ijuru

Nagutera Mukara ikamwe ayera murumana wa Muhoro : umuyenzi

Nagutera muremure waje none : umuganda

Nagutera Mvuye kure wa Semutiku : igitonyanga cy'imvura

Nagutera Nyabishishi i  Nyabitare : urukumbi mu menyo 

Nagutera Nyamuniga wa Nyamuko : umutsi w'innyo

Nagutera Nyamuniga wa Muko : ikinyoro cy'umusaza

Nagutera bNyamutukura umututsi : igisabo

Nagutera nyamuremure waje kera : igitonyanga

Nagutera Nyiraforongo : imbwa mu masinde

Nagutera Nyirampirigita ombaba zitarya : ifuni mu rutara

Nagutera Nyirahanga amenyo abiri : ibikingi by'amarembo

Nagutera nzaya : injuma y'uruhinja

Nagutera Rudakambirwa rwa mugabo udafungura akebo kamwe : imvura

Nagutera Rugaju mu rugo rw'imigano : ururimi mu menyo

Nagutera Ruganji mu nzugi : igikobwa kibi

Nagutera Rugina igana intaho : ikizubazuba

Nagutera Rukara aho igaramya mu bitare bya Mashyiga : urukumbi mu menyo

Nagutera Rukara hejuru y'urupfu : ubwato mu ruzi

Nagutera Rukarata ruje rukamaira : ababirigi

Nagutera Rukinga rugana ikimpakamba cy'amaso munani : ikigagara

Nagutera Rusharara Imana y'i Gisaka : intimba mu nda

Nagutera Rutambuka kibaya rwa Semugeshi : umusambi

Nagutera Rutare rwa Sebayanda rwasa inguma igihumbi : urusyo

Nagutera Rutumba ruturitse rutare rw'iyapfuye ejo : isekurume y'intama 

Nagutera rwagikoba rwakimanika rutaribwa n'imbeba : inzogera 

Nagutera rwagikoba rwakimanika rutaribwa n'imbeba : inzogera

Nagutera rwa kimanuka rutaribwa n'imbeba : inzogera

Nagutera rwa Kimanuka rutaribwa b'inyoni : umwijima

Nagutera ububumbabumbe bubiri mu itaba ry'umusozi : amabere

Nagutera umuriro uzimya undi : igishirira kiguye mu mazi ashyushye

Nagutera umutumbagiro wa Rujugira : umwumba w'urukoma

Nagutera uruhumbuhumbu uruhumbura Jana : inyenyeri

Nagutera urujeje uruhumbura Jana : uruyange; amaguru ya muhuhirizi

Ndateka imirire ni yo yanyobeye : umwana ugaburirwa na nyina w'undi

Nagutera uruyongoyongo rwa Nyirabaha rwimiye i Nduga rukabyarira i Nduga : uruzi; ishami ry'uruzi

Nagutera uruzungu uruzunguriza murizo rwagiye uruzunguzungu gahahira abana rukararirana : ikinyabwoya; uruyongoyongo

Naguze igote nkivuka na n'ubu ntirirasaza : umubiri w'umuntu

Nahagarara aha nawe ugahagarara hakuno twareshya : insina y'ikinyangurube

Nahinze umurima utagira ikiyorero : uruzi

Nahurenye inko nyinshi ncyurana imwe gusa : umusigati

Nakunombanomba nagukatakata ni ingabo yanjye rukatiriza : agakatsi ku butanda 

Nambutse uruzi nkubita umwogo w'inda hasi : intashya

Nambutse uruzi ndangaje innyo : umugata

Narabudoze ndabudanagira nabukubise ku ngoma ya Rukatiriza : ubutanda ku muvure

Narubanda ntiwarubandura : icyuho; ikibyindi

Narakuze ndakururumba nanirwa no kwasa inkwi : igihondohondo

Narariwe n'inyamaswa bukeye mbura amajanja yayo : ijoro

Nasanze nyamunsi yasa inkwi munsi y'inzira : inyamanza

Bashinze urukiramende ku ngoma ya Gahindiro n'ubu sindarugendera ngo ndusimbutse : amahembe y'inka

Navutse mpinnye urutoki : umugondoro w'ibishyimbo

Nateye agati kange ari igozi kamanuka ari igogo kirahira inyabihigo Kandi katagira n'inkoma rutaro : ikijumba

Ncukuye urwina sinatara : igihandure

Ndagiye gitare mu makoro ntiyakomereka : ururimi mu menyo

Ndagukubita nkakwitaza nitwa umugaragu wa Mburamatare : gusitara ku ibuye

Ndaguteruye ndakwesa urahindukira urandeba : ubunyerere

Ndamutemye ndamutaruka : umutumba w'insina

Ndara mpinga bugacya : agahinda ku mutima

Ndasera i Gahanga nkagosorera i Kabondo : guhekenya amasaka

Ndashe akambi ku Karubanda abami n'abamikazi baratanguranywa : akazuba karashe

Ndashe akambi mu Rwanda abagabo bose barakangarana : umusoro

Ndasiye inuma ku mukimbagiro wa Bugoyi ahi kuva amaraso iva ifu : ikinyugunyugu

Ndanze akazigiro niteye agahaza : akayuki k'akungu

Ndica simporwe : uruzi 

Ndi mugufi nyirazo : igicaniro; igisabo

Ndi mugufi ndi ny'irumukenke : igisindu

Ndu mugufi nakiranya so nkamutsinda : ubunyenyeri

Ndi Rutebuka kw'iteme ndi Rutebuka ku iteke nti "mbe mwiriwe Rezida !" : urukwavu

Ndumiwe ndakavuna umuheto : umugabo unnya mu ruhira akabura icyoyihehesha

Nduzi abamikazi bateze inigi : uruyange rw'amashaza

Negetse umuzinga ku ngoma ya Gahindiro n'ubu nturinjira : imyenge y'amazuru

Ngakariya : akato mu kiyaga

Ngateke ngatakure ngashimire ubwiza kameze : inyenyeri

Nageze mu irembo ndasitara : urugo udasangamo nyoko

Ngeze mu gahinga mfunga feri : akarizo k'ihene

Ngeze mu mpinga mpinguza abahinzi : ivunja

Ngeze munsi y'urugo nkuka itako : umwana usanze se na nyina batariyo

Ngira abana bagaturana ntibaramukanye : inkombe z'uruzi; ibikingi by'amarembo; inkomanizo z'umuryango

Ngira abana bakarara bahagaze bwacya bakaryama : imyugaruro

Ngira abana umuto yatanze umukuru gusabwa : icyagumbwa (inopfu) 

Ngira imbehe nyinshi ariko mbura iyo ndiraho : ibiganza

Ngira imbuga nayiharuye ku ngoma ya Gahindiro n'ubu ntiramera akatsi : ikiganza

Ngira ingabo ikankingira abantu umunani : ikirago

Ngira inka igakamwa igaramye bwira ikubama : umuvure

Ngira inka iheta ibitugu igasimbuka urugo : ikivumvuri

Ngira inka ikarisha kure bwira igataha ku muryango : ijisho

Ngira inka ikarisha mu Rwanda rwose : ijisho

Ngira inka ikimira mu kinono ikabyarira mu kanwa : insina

Ngira inka nkayibagira hagati y'imisozi itatu : inda 

Ngira inka nkayikamira mu rubavu : ikigoli

Ngira inka nkayikamira mu murizo : inkono y'itabi

Ngira inka nkayirya igenda : uruyuzi; umugezi

Ngira inka nkayisasira amahwa nkayorosa andi : ururimi

Ngira inka nkayivanaho  uruhu igasigara ihagaze : umuvumu

Ngira inkongoro nkazogereza hejuru y'uruzi ntizigwemo : amenyo

Ngira umurima w'ikibugabuga w'ikiyorero kimwe : ukwezi ku ijuru 

Ngira umugozi nkawutahiriza ntiwuzure : inzira 

Ngira umutabo ugahingwa n'isuka y'indoko : inkinwa cya Nyirabarazana

Ngira umwana akabyara umugenda : uruyuzi

Ngira umwana akagira ingingo zigerekeranye : icyibo

Ngira umwana akarara agenda : umugezi

Ngira umwana nkamugaburira urushyi rumwe agahaga : inkono y'itabi

Ngira umwana nkamutega amasunzu nkamutuma mu ishyamba : umwambi

Ngiye mu ibarabara nsanga akagaramiye  inzira : agakongorerwa

Ngiye mu mpinga mbona abagenzi beza : imigeri

Ngiye bambaye ubusa ndi akana ngaruka narabyaye Kandi nambaye : ikigori

Ngiye nca amayogi ngera iyo nshaka : umuhanda

Ngiye ndi imbere ngaruka ndi imbere : akabuno k'umwatiro, akanyita k'uruhu

Ngiye inyuma y'inzu ntoragura umuhoro : uruyongoyongo

Ni jye muzindutsi wa cyane nasanze agasaza n'agakecuru batanye ku munigo : ikibando n'urugi; urugi ku muryango

Ni jye muzindutsi wa cyane nasanze aho urupfu ruteze urugori : urubumbiro; itongo

Ni jye muzindutsi wa cyane nasanze aho urupfu rutunga inigi : urume ku musororo

Ni jye muzindutsi wa cyane nasanze kwa Byucyucyu bacyugariye : akabuno k'imfizi

Ni jye muzindutsi wa cyane nasanze umuzimu yicaye ku kaguru : inkware

Ni jye muzindutsi wa cyane nasanze umupfu atsibagura inzira : umunyorogoto 

Nirirwa nicaye nkirirwa nicaye : intebe

Nirirwa ntambuka bukira nkibatambuka : umutumba

Nishe inkuba nyihambiriza indi : guhambiriza igitoki ibirere; guhambiriza inshinge Indi

Njugunye akabuye ku Karubanda baragatanguranwa : ifaranga

Njugunya njugunya nupfa tuzajyana : umusatsi; inzara

Nk'aka kanya : imashini idoda (icyarahani)

Nkoni mu kugukubita yarakuneshaga : uruyuki

Nkubise agahini hasi nti bazimu nimuzuke : imbogeri

Nkubise agahini hasi nti bazimu nimuzuke : umutozo

Nkubise inda hasi ndamutsa umwami i Remera : intasya

Nkubise inkoni hasi ndi mu gikari intanga ikambere : amazimwe yo ku rurembo

Nkubise urushyi rurumira : ibara ry'inka

Nkubise urutare mbona imyase : inkuba

Nkubise uruti mu nkike ya ruguru ruhinguka i Nyarugenge : umuntu ubara inkuru cyane

Nkurira umuhoro mu rutoki : uruyongoyongo

Nkurusha umukobwa urongorwa n'abagabo batatu : inkono ku mashyiga

Nkuruye urubingo ruhinguka rwose : inzara mu bana

Nkuruye urusuri ishyamba rirahungabana : inzara y'umusore; ijambo ry'umwami

Nsanze aho urupfu rwihaganyura : ifuni mu mushike 

Nshagawe ntari umwami : umusore warongoye 

Nshibwa nshibuka : urukangaga

Nshikuje umubugu ugugesera burahungabana : inzara yica umusore

Nshinze umwe ndasakara : igihumyo; umwobo

Nshiye mu ishyamba rimpa umwezi : ibarizo

Nshyigikiye mu ruzi ndaswa : agatsinsino

Nsimbutse umugende nnya ibuye : uruyuzi

Nsize agakongorerwa haruguru y'inzira ngarutse ngasanga hepfo yayo : ijambo rya mukeba 

Nshoye inka nyitambitse nyikura nyihagaritse : ikibyindi 

Nshoye mukara nkura mweru : amamera n'ifu

Nta kamwe nta akandi ngere iyo!! : udukongorwa

Nta musimbutsi wa cyane wasimbutse urugata : inzoga

Ntereye agashami mu gishanga amashami akwira irwanda : ijambo ry'umwami

Ntereye agasozi ndashya ndashyenga : inda mu ruhara

Ntereye akabuye mu gihuru kagaruka kavuga amanzenzi : umuvumbuko w'intare

Ntereye intobo hakurya y'uruzi, Indi nyitera hakuno zihuye ziriganira : indishyi zihuye; imfubyi

Ntereye Ndiza ngeze mu mpinga nibuka umugenzi nsize inyuma : uruheri mu gihata

Ntereye Ndiza urwenge rurahonya : inda mu ruhara

Nteye ijuru umusonga : agasongero

Nteruye nyoko n'ubuhuruhuru  ndunda mu mbere : inkono n' ibipfuko

Ntoye umuhoro ntema icyo ntaribuce : amazi

Mtumye Mbindigiri i Nyanza : inkangara

Nturutse hanze ndeba umuntu ngeze mu nzu ndamubura : agasongera

Nturutse munsi y'inzu numva rwabugiri avugirza : inshunzi mu cyansi

Nubatse urugo hejuru y'urupfu : ubwato mu kiyaga; mu ruzi

Nuriye umugogo nnya ibuye : uruyuzi 

Nyabugenge n'ubugenge bwayo : inka icurika icebe ntimene amata; inzoka igenda itagira amaguru

Nyabukongoro yamaze inka i Murera : uruhabuzo

Nyabwiza mu mpinga : umbwato; ibitwikurura

Nyabwumira mu ijana : urukorogoto

Nyamutanga irabundikiye : inzu

Nyamudugudu wa Bwungwate : imbwa mu masinde, amarira y'imbwa 

Nyamukata ntimena : ikirenge 

Nyamukubura umutindi : umwisheshe

Nyamunimba wa Muko : umutsi mu nda 

Nyamunini umugwa-mpinga : umuduha

Nyamunombanomba wa Munombano uwakwenda rwakwendana : urutoki mu nkono y'itabi

Nyamunsi aragendera hejuru y'urupfu : umushoferi w'indege

Nyamurenga na Nyiragongo bashinze akaburi : inuma mu ntabire

Nyamurenga i Buzi : isake; impanda

Nyamutukura umutindi : urubwija

Nyamweru mu matovu : imegeri

Nyamwiza mu ibanga : umwangange

Nyangufu araseka uburo : ifundi mu murama

Nyiransibura i Burundi : umurabyo

Nyiribwirima na Mwemanyi baciye aho bagomagira : amata n'umutsima

Nyirabambari yambaye impu munani : ikigoli

Nyirabazaza ntaruha : inkono mu mashyiga

Nyirabigiribigingiri : agacurama

Nyirabigirigita mu murombero : umugore ujya kuzimura 

Nyirabugazi arazigaramiye : akazi mu nzira

Nyirabujunjuri ubujunjuri : amashaza ku rujyo

Nyirabujyuguri ubujyugurwa : ubunwa bw'ikirondwe

Nyirabuki irabyina impa : imondo mu gihu

Nyirabukimana arakima ubwa ruguru : akanyarirajisho

Nyirabumpurimpuri arabyina haruguru aho : izo ngohe zawe

Nyiraburemo bamurengeje urugo : ibipfuko

Nyirabyiri ntacyshirira inyana : ibisya by'umutwakazi

Nyirabyuma ndashya umugongo : urusenge

Nyirabyungwane : amarira y'imbwa

Nyiraforongo : amarira y'imbwa 

Nyiragirimana afite inde : uruboho

Nyirakamuga mu mpinga ya Kamonyi : umwungange

Nyirakaruhura intumwa y'urupfu : ibitotsi

Nyirakibindigiri mu Mutara : intete y'ururo

Nyirakigeri  aganje mu mpinga Ntumba : ikiziba mu mpinga

Nyiramaganya inyuma y'urugo : indiga mu ihene

Nyiramahenagurwa : urutare rwo mu nzira

Nyiramakangaza ngo mutahe : imbeho ku rugi

Nyiramakegete ararurenze : ikivumvuri

Nyiramakoberanya : agakono ko mu cyi

Nyiramana yadehesheje : Ingoma mu isoko

Nyiramangange : amarira y'imbwa

Nyiramaha hinda : imende ku ruzi

Nyiramangiringiri nyir'amaso munani : urutete

Nyirambonyubwayo agiye iwabo : inturo mu muvumo

Nyirampoyongo : imbwa mu masinde

Nyiramparagata bivemo umukwe wa Minani : umusure mu ngungu; ikinya mu kwaha

Nyirampirima umwami w'i Ndorwa : imodoka

Nyirampiri n'impiri yayo mu nyonga y'umusozi : inturo mu Ntare

Nyiramagarama ari n'inda : intubu n'urutwe

Nyiramugirimbwa afite inda : igikeri

Nyiramukuru umuturirwa : umucundura

Nyiramwiza mu mpinga : imondo; impongo; urugo rw'umwami

Nyirancubakirimo : imondo mu gihu

Nyirancurucumba aracura inkweto : inkoko mu rutoki

Nyirampirima aratwite : akamuga karimo ibishyimbo

Nyirandirima umugore munini yicaye icukiro : ikiyege

Nyiranduguru ingoma y'abashi : ibirayi

Nyirankungurumanyu : igihuru gihiye uruhande rumwe

Nyirankurugutamuheto : imbeba mu muguta 

Nyiranshoreke : agacuma

Nyiranyanyagara inkumi nziza mu nzira : inuma 

Nyirarupfu aradehesheje : icyiyoni mu isoko

Nyoko arusha mama amabuno manini : igitembatembe

Nyoko ko ari munini yakwambara inkanda ya Ruhondo? : ijuru; uruhu w'imbaragasa

Nyoko na mama bapfuye iki? : agahaza ko mu rubibi; inkongoro z'abana

Nyoko ntannya aracuncumura : igicuma bacuncumura

Nyoko yagira impanga mbi irakamurasa : igisenge cy'inzu

Nzamutse agasozi ubutogotogo buramvuna : ubuhuzu mu bitugu; inkota mu bitugu 

Nzanira isuka ndamweguye : ivunja

Nzapfa nzakira simbizi : akanyoni karitse ku nzira

Rambagira Budongo : imodoka mu muhanda

Rudandi na Rukambura : inzara n'umwijuto

Rugaju ruberezi : igisate cy'umutsima

Rugangazi rugangaye mu nzuzi : ikinyabwoya

Rugaragura mugabo rwa mugabo ikuzimu yahidirimanze : umwumbati

Rugaramana ngabo wa Ngabonziza : igisenge

Rwagerinyange rwa Nyenyeri inyambo yo kuri Mwongo : ikirungurira

Rugugura yaguye inyuma ya Ngiga : imvura igwa ku gitikatika

Ruhuga iratema imanga : umuriro

Rukabyamurimbo wa Muririma ntagikoza ibirenge hasi : umusambi; abashi b'inkingi

Rukandagira amabare rwa maguru munani; rukara iryamiye umukumba : imisoto y'ikigega

Rukara iracumita Rutare yanga : inda mu musatsi

Rukara ipfukamanye n'urupfu : ubwato mu ruzi

Rukara irajegeza umudende : urushishi ku igufa

Rukara irona umurama : inda mu ruhara

Rukara rya kinege ntiribwa n'imbeba : isuka

Rukara rw'amacece aturutse hirya wayacekwa : umusirikare

Rukara rw'amacece aturutse hirya nyoko arayacekwa : imodoka

Rukara rwa Nzamba yaturuka mu marembo wayacekwa : umubirigi

Rukara rwa Nyabicuma yaturuka hariya wayacekwa : ibyiyone

Rukina ma gasiza rwa Senyakazana twigabe : umusambi

Rukondakonda yamaze inka i Murera : uruhabuzo

Rukondakonda umuhoro wo mu Kinyaga : uruyongoyongo

Rukubita hasi rwa Sahaha : inkuba mu rugano

Rumanika amahahara rumanura amahoro : inkumi yiba

Rupfu irinopfora umushike : ifuni

Rupfupfu yarapfuye adiga undi Rupfupfu : umugezi utemba ugasiga amabuye

Rusengo mu miseke : umwobo mu masaka

Rushiramazinda rwa ntibazirikana Rubanda mushishwa nabi : gusaba uwo wenyine

Rushinyika rushaje you rugina rw'uwapfuye ejo : urutozi

Rusimbuka mu gicu rwa Semugeshi ingombwe ya Rugina : ingwe

Rusimbuka mu masaka umwami w'abaderevu : umusambi

Rutagataga rwa Karimumatongo umwambere wa Buzutu : inda

Rutambamira amabare imfizi y'amaguru menshi : ikigega

Rutamu ni mutanga urutanga ihene gutaha : ikizubazuba

Rutangira yamennye intango : umwobo mu nzira 

Rutikanga yamaze ubwatsi : umusambi 

Rutinda ku iteme ntirutebuke: igitabo cy'umusoro

Rutinda mu idadi Rutebuka mu iteme bwakweye Dede!  : ibijumaba

Rutondagitamugogo mugabo utuye mu ishyamba : indarama 

Rutubya amarobe rutubura amabondo umusonga wa rugadika : ikirungurira

Rutuku rwa Ndubaruba yari umugabo nuko yasize imbwa : umuriro

Rutuku rw'umuzungu kuri ubu ageze he? : intobo

Rutumba ruturitse rw'i Buganza irangana iki? : amaguru k'urushishi

Rivudukana imbaraga ruvumera rutagira amabere : imodoka

Ruvumba rwa Rugeyo nta musore uyisakarira : imyotsi

Ruvuzo irivuga ikibumba : inzoga mu kibindi

Ruvuzo ikwirukana mu nka : imvi zikuye umusatsi w'ubuto

Rwamacugi iracugita nyoko : inda mu nkanda 

Rwamirenge i Bugoyi : isake y'inkoko

Rwegamanangabo rwa Ngaboyegamanye ingabo mu nkike ya ruguru : urushishi rufite ishaka

Rwerinyange rwa Nyenyeri inyana yo kuri Mwogo : ikidasesa

Rwigimba irarenga mu mpunzu : ikinyabwoya

Rwigira inturike : intumbi y'ihene

Sakuza na Mugemajuru : isunzu ryawe

Sakuza n'uwo murikumwe : ururimi rwawe

Samuduha ku mubanga : ikinyoro mu Gahanga k'umusore

Sarupfu yikoreye Sarupfu yindi : umuntu uri kuri ipikipiki

Sebihu sogokuru : igihuna

Segikwekwe umutwe wa Mukono : umuko mu mukokwe

Sehene agiye iwabo : inturo mu rutare

Serudigadiga wa rututsi rutura ku nziza : urutumbwe

Serushababisha ni mwene rugadiga : inguri

Sesera aha dushire : amasaka ku rusyo

Shaka agafuni nshake akandi tujye kurima imizi ya Ruhozozo ikuzimu : imizi y'urutare

Shirika amazinda ngutume ikuzimu : umusomyo mu ruzi; umuganda w'inzu; umucaca mu iriba

Shinga unegeze : akarizo k'ihene

Shorera Ruhushi tujye gukwa nyoko : icyugu

Sine irarisha hejuru y'urupfu : ubwato mu kiyaga; mu mazi

So arongora nyoko amucuritse : ishoka mu rukwi

Sogokuru ajya mu birunga yanzuze he? : amazi mu gisura

Sogokuru aryoha aboze : umuneke

Sogokuru apfanye impatwe : igiti gishigukanye n'imizi yacyo

Sogokuru Sebarame yapfuye apfuna ivu : imivuba; inkono y'itabi

Sogokuru w'ibihigi nyinshi : umutobotobo

So na data ko bameze impara inzoga y'ibwami izakorera nde ?:ibihaza

So na data bava inda imwe batanyijwe n'iki? : inkombe z'uruzi

Tabara ibibuno bya nyoko birenze urugo : ibivumvuri

Tamba nyoko aratetse : inkono yuzuye ibiryo

Tabara umwana w'umwami agiye kugwa mwiriba : umucaca

Tarataza tujye i Mataza : umutanoga ku rutare

Terura Mutamu uyitereke ku rutare uyikize ubutuna : amateke

Terera Rubona ubone ishyano : uburiri bw'umwami

Tora  agahini ntore akandi tujye gushaka icyo tutazabona  :  imizi y'urutare

Tora agakoni ntore akandi tujye gukubita Ruyiyenza yamaze ubwatsi : umusambi

Tora akato ntore akandi tujye kwambutsa akanyarumira : umugore utwite

Tora akebo ntore akandi tujye gutara intagwira : inyabutongo

Tora akuho ntore akandi tujye guhaha igume hepfo aha : inkari z'inkoko

Tora ifumba ntore Indi tujye kwibaza : gutsika uruzi

Tora inkoni ntore Indi tujye gutsimbura Rukara ku gicaniro : umwijima

Tora ubuhiri ntore ubundi tujye kuvumbura inyamaswa itagira umurizo : intosho

Tora uruho ntore urundi tujye kwiyumya : amaganga y'isha

Tujye kwimira rutimirwa : umusambi

Turadundaraye : utubyi tw'umushumba

Turatemba shyashyari : uruzi ku rutare

Twabirikana mwimanyi : umwobo w'impiri

Twagize umuzinga ku ngoma ya Gahindiro na n'ubu nturinjira : amazuru

Twavamo umwe ntitwarya : ishyiga ry'inyuma

Ubonye ngo tuvugane ijambo ndisange munsi y'inzira : igikongorwa

Ubugeni bw'ino burampuha : wasaza ubuhiri mu muhini!!

Ubumomo so ubuguru bw'isi : amaguru yanjye n'ayawe

Ubunyenyeri bwa Karongi bwaciye intungura ibara : umbusore ugwanye ingabo

Ubuze umuhire yifasha umunyagasani : uburo ku rugo

Ubwo twicaye hano haraza umuntu aduhamagareb: ibitotsi

Ubutunguru bubiri bwambutse ingezi : amaso

Ugiye mu rutoki ubanza iki? : ikivugirizo

Ujya kurasa inkuba arabandama : kwatsa mu ziko

Ujya kukwica aragusekera : gusitara ku ibuye

Uko turi iwacu twese turi bagufi : amashyiga

Umugabo urimbana impuzu mu mpinga ya Gihubuke : ikinyabwoya

Umuntu muremure w'imyenge mu nnyo n'umwenda wera : injishi z'igisabo

UmUsozi warahiye hasigaye Rukara rwa Shaza : igisambu gisigaye hagati y'uruhira

Umututsi muremure yagutanze ku iriba : igitonyanga

Umututsi muremure yamaze imigondoro mu murima : uruhabuzo mu ntoke

Umwami w'i Buhaya aratera ingoma araramye : inuma ku ishaka

Umwana wanjye yavutse afite inda : umuheha

Umwana w'umutwa yaruka warya : inkono

Umwana w'umwami amanutse akubita agatoki ku kandi : akababi k'umuvumu

Umwana w'umwami hejuru y'urupfu : ubwato mu ruzi

Umwana w'umwami yaruka wanywa : igisabo

Umwobo wa Dede uturamo Dede wenyine : umwobo w'inzoka

Urace inkoni ngufi turagiye mu ishyamba : umusigati

Uragaramye i Buganza n'inkindi n'inkweto ntuzi ko bwakeye : akayuzi hejuru y'urupfu

Urambaze wampaye iki? : umugozi w'ibijumba

Uransaba ndaguha : imyenge y'inzu

Urarenga mpinguka : umusaza n'umwana

Urudigidi uruvuza mudido : urutumbwe

Uruhetehete ruheta abagabo : urubariro

Irwanda rwose iya bitatu : amashyiga

Vuga jye nahoze : umuce wo mu irebe

Wacana mu ruzi umuriro ukaka? : radiyo

Wambukije umwami utagira amaguru : urusyo

Wanzitse mu ruzi ndasya : urusenge

Watambana ingabo mu rutare : radiyo

Waterera Sebaya ntiwayiheza : umurizo w'ihene

Wavuka wari waterera cya Mahangire : umurunga

Wikoza hasi wikoza hejuru ntuzabona ishinya ya Dede : ishinya y'urukwavu; ishinya y'urushishi

Wihogora agiye ibuheza : intore mu muhogo

Yagira amajwi meza arakagira Rudatenguka : radiyo

Yatangiye kubaho ari umwe kugeza n'ubu akiriho Ari umwe : urupfu

Zabukatakata zabunombanomba : inyambo z'umutindi

Zagarika amahembe ntiwamenya iyo nyoko yakowe : ingara z'iminyinya

Zana icyansi cy'amatwi irinikiye : ikinyankari

Zaturuka mu irembo ntiwamenya iyo nyoko yakowe : ifundi

Zigeze mu marembo y'abampata zirarima : uruheri mu gihata

Zikutse zera inzara : imfunzo

Zirindiye i Bukoma : inzuho ebyiri mu ntango

Zimanutse i Mageri zabagira : impururu z'ababi

Zirabunombanomba zirabukatakata inyambo za Mukeshimana : akabwana mu gatabire

Zirahutse zisiga umubisha ku nama : intorezo n'irago

Zirahutse zisiga mweru mu rugo : ingwa

Zirakutse zisiga mweru inyuma : isinde

Zirahutse zisiga mweru ku iriba : inyamanza

Zirarima mu bikombe bya Ndiza: inzara mu ruheri 

Ziramuje mu Nyarubande : intuku z'amasaka

Zirashotse zisiga mukara mu ibuga : igishwemu cy'amase

Zirava inyuma zose : inzuki

Ziravuga i Nyamirama : inshuzi mu cyansi

Zishotse zitendeje zikuka ziteye hejuru : abavomyi